谢谢 你 所 做 的 一切	你 开心 就 好
你 开心 就 好	开心
开心	嗯 因为 你 的 心里 只有 学习
嗯 因为 你 的 心里 只有 学习	某某某 还有 你
某某某 还有 你	这个 某某某 用 的 好
你们 宿舍 都 是 这么 厉害 的 人 吗	眼睛 特别 搞笑 这土 也 不好 捏 但 就是 觉得 挺 可爱
眼睛 特别 搞笑 这土 也 不好 捏 但 就是 觉得 挺 可爱	特别 可爱 啊
今天 好点 了 吗	一天 比 一天 严重
一天 比 一天 严重	吃药 不管 用 去 打 一针 别 拖 着
是 的 下辈子 想 做 只 萤火虫	可是 萤火虫 太 容易 被 抓 了 还是 改 一个 吧
可是 萤火虫 太 容易 被 抓 了 还是 改 一个 吧	不 我 只 想 奋不顾身 扑火
加油 三月 动 起来 五月 笑 起来	正解 你 为什么 就 那么 厉害 呢
正解 你 为什么 就 那么 厉害 呢	哈哈 没 办法 智商 就是 这么 高
哈哈 没 办法 智商 就是 这么 高	你 这 是 要 开始 得瑟 了 吗 好 啦 你 最 厉害
你 这 是 要 开始 得瑟 了 吗 好 啦 你 最 厉害	哈哈哈哈
好身材 秀 出来	哈哈哈 其实 我 是 胖 的
哈哈哈 其实 我 是 胖 的	不会 的
因为 我 网络 差 吗 加载 不 出来 啊	是 什么 网络 啊 移动 的 可能 比较慢
是 什么 网络 啊 移动 的 可能 比较慢	啊 真的 是 我 自家 网络 的 问题 用 别家 的 就 好 了
这是 克拉玛依 咩	对 啊 有没有 啥 推荐 的 快快 快
对 啊 有没有 啥 推荐 的 快快 快	哈哈哈 哈哈 要 吃 东西 的话 就 去 那个 汉博 那边 比较 多 克拉玛依 的 凉皮 也 可以 尝尝 然后 可以 去 九 龙潭 看看 克拉玛依 图书馆 啊 一号 井 啊 都 是 克拉玛依 旅游 比较 常去 的 地方
哈哈哈 哈哈 要 吃 东西 的话 就 去 那个 汉博 那边 比较 多 克拉玛依 的 凉皮 也 可以 尝尝 然后 可以 去 九 龙潭 看看 克拉玛依 图书馆 啊 一号 井 啊 都 是 克拉玛依 旅游 比较 常去 的 地方	良心 评论
这个 側颜 可以	这个 繁体 很 厉害
这个 繁体 很 厉害	为了 配 你 的 颜
为了 配 你 的 颜	哥
我 今天 腿 都 废 了 你们 过节 我 搬 砖	辛苦 啊 圣诞节 还 去 赚大钱 了 加油
辛苦 啊 圣诞节 还 去 赚大钱 了 加油	毕竟 是 没 男朋友 的 人 什么 节 都 是 一样 的
保留 几分	晾 毛巾 晾 毛巾 叫 你 天天 晾 毛巾
晾 毛巾 晾 毛巾 叫 你 天天 晾 毛巾	看看 几点 了 还 不快 去 吃饭
经常 都 记着 出门 要 带 学生证 每次 都 忘	我 刚检 完票 候车 就 发现 了 但是 来不及 了
我 刚检 完票 候车 就 发现 了 但是 来不及 了	尴尬
嘉宁	胸 不错
胸 不错	摸够 了 吧
摸够 了 吧	小小 贡献 不足 为 提
我 也 看过 了	握个 手 吧
握个 手 吧	好 的 勉强 同意 了
哈哈哈 哈哈哈 哈哈哈 哈哈哈	你 哈哈 个 啥
你 哈哈 个 啥	别人 晒 得 都 是 某某某 搞 事情 为啥 只有 你 是 瘦 了 太 尼玛 懂 你 了 笑 哭 我 了
别人 晒 得 都 是 某某某 搞 事情 为啥 只有 你 是 瘦 了 太 尼玛 懂 你 了 笑 哭 我 了	这个 太假 了
南通 的 海风 真的 是 扛不住	还好 啦 挺 惬意 的 园 博园 的 海风 才 舒坦 有 兴趣 可以 去园 博园 吹 吹 海风
还好 啦 挺 惬意 的 园 博园 的 海风 才 舒坦 有 兴趣 可以 去园 博园 吹 吹 海风	滨江 公园 的 风 已经 很 可以 了
看着 就 难吃	又 不是 你 吃 莫 操心
又 不是 你 吃 莫 操心	心疼 你
心疼 你	滚蛋
滚蛋	不滚
外出 了	嗯 啊
嗯 啊	好 好玩 注意安全 哈
你 中招 了	差不多
差不多	那么 大人 还是 要 注意 点
我 也 预定 了 重庆 站 月 的	可是 号 已经 售光 了 啊 我 打算 买 号 的
可是 号 已经 售光 了 啊 我 打算 买 号 的	号 显示 的 缺货 然后 我 缺货 登记 了 两张 号 的 呢 啥时候 开始 售
号 显示 的 缺货 然后 我 缺货 登记 了 两张 号 的 呢 啥时候 开始 售	哈哈哈哈 原来 是 这样 啊 我 用 的 软件 只 显示 了 马上 开售 不 知道 撒 时候 售 啊 太 揪心 号 的 就 没有 买到 号 的 一定 要 买 到 啊
哈哈哈哈 原来 是 这样 啊 我 用 的 软件 只 显示 了 马上 开售 不 知道 撒 时候 售 啊 太 揪心 号 的 就 没有 买到 号 的 一定 要 买 到 啊	好 伤心 啊 你 是 什么 软件 我 都 不 知道 在 哪儿 买
男票 哈	放荡不羁 爱 自由 的 我 哪里 来 的 男朋友 呢
放荡不羁 爱 自由 的 我 哪里 来 的 男朋友 呢	哈哈哈 还是 酒太 好喝 手机 太 好玩 的 过
小迷妹 上线 了	嘻嘻 嘻 昨天 农大 的 乐队 唱 的 好好 听
嘻嘻 嘻 昨天 农大 的 乐队 唱 的 好好 听	那 乐队 叫 什么
那 乐队 叫 什么	朝 北
朝 北	哈哈 我们 班 的 同学 组 的
哈哈 我们 班 的 同学 组 的	真滴 啊 那 佳佳 你 听 过 他们 的 现场 没
真滴 啊 那 佳佳 你 听 过 他们 的 现场 没	我 没有 诶
我 没有 诶	我们 微信 说 吧
骑 来 沈阳 我 带 你 飞	我 害怕 飞 到 沟里
我 害怕 飞 到 沟里	不怕 毕竟 你 这么 美
张着 嘴 晾着	哈哈哈 哈哈 我 假装 没 看见 这个 时间 点
哈哈哈 哈哈 我 假装 没 看见 这个 时间 点	诶 我 说 啥 了 嘛 不 记得 了
上面 在 贴个 透明胶	试一下 咽 的 我 感觉 嗓子 都 麻 了
试一下 咽 的 我 感觉 嗓子 都 麻 了	我 闹着玩儿 的 你 还 真 贴
啦 啦 啦	啪啪 啪
啪啪 啪	清明 假去 哪 玩
李美人 尚小 小朋友 要 多 看书 了	我 就 不
我 就 不	没事 你 帮 我 存着 我 来看 监督 我
没事 你 帮 我 存着 我 来看 监督 我	你 带 着 我 看 小 黄书 就 够 了
你 带 着 我 看 小 黄书 就 够 了	小 黄书 我 都 可以 自己 写 小 黄片 吧
想当年 我 的 六年级 在读 霸道 总裁 爱上 我	你 那么 快 我 还 在读 校园 言情 呢
你 那么 快 我 还 在读 校园 言情 呢	我 六年级 都 已经 看 都市 言情 了
淘宝 啊 一块钱 永久 每天 五糖 . 五块 钱 永久 龙蛋 啊	兄弟 你 买 贵 了 我 这元刷 龙蛋
兄弟 你 买 贵 了 我 这元刷 龙蛋	我 是 出 的 当天 买 的
百度 搜索 球球 大 作战 刷 棒棒糖 辅助工具 链接 放 里面 就 可以 了 不用 这么 麻烦	免费 的 嘛 那 我 还 花钱 点 永久 了
免费 的 嘛 那 我 还 花钱 点 永久 了	免费 呀
免费 呀	好 吧 我 还 在 淘宝 上 花钱 点 了
好 吧 我 还 在 淘宝 上 花钱 点 了	土豪 我们 做 朋友 吧 把 钱 给 我 保 你 天天 龙蛋
土豪 我们 做 朋友 吧 把 钱 给 我 保 你 天天 龙蛋	给 你 三块 要 不要 哈哈哈
给 你 三块 要 不要 哈哈哈	你 在 淘宝 花 多少 钱 呀
你 在 淘宝 花 多少 钱 呀	元龙 蛋 还 没 让 点 了
元龙 蛋 还 没 让 点 了	加微信 我 告诉 你 咋 点
加微信 我 告诉 你 咋 点	私聊 你 了
我 今天 开 两个 一个 是 六个 一个 是 七个	你 更 厉害
你 更 厉害	我 可能 开了个 假 的 宝箱
饿 了	我 做好 邮寄 给 你
我 做好 邮寄 给 你	真的 吗
真的 吗	是 滴
她 是 年 的 优华	天啦噜 好 小 啊
天啦噜 好 小 啊	笑 起来 很 治愈
蓝色 好看	买不起 只能 欣赏 一下 小姐姐
买不起 只能 欣赏 一下 小姐姐	传说 中 的 治愈 系 笑容
大大 命主 青龙 还会 出 吗	会 的 宝宝
会 的 宝宝	好 的 大大
太太 瑕疵 本 周边 全 吗	应该 是 全 的 可以 问 下 客服 不过 最近 查 印刷物 要 关店 到 .
应该 是 全 的 可以 问 下 客服 不过 最近 查 印刷物 要 关店 到 .	我 昨天 就 买 惹
大人 很早 很早 之前 买 的 本 现在 才 发现 里面 有页 左右 印反 了 现在 还 能 换 吗	是 哪本 一派 狐言 咩
是 哪本 一派 狐言 咩	嗯 嗯 嗯 可以 吗 不过 是 很 久 之前 了 而且 书 在 学校 里
嗯 嗯 嗯 可以 吗 不过 是 很 久 之前 了 而且 书 在 学校 里	谢谢 大大
谢谢 大大	不 客气 哒
攻 自己 交了 白卷 给 受 写 满 了	攻 把 卷子 写受 的 名字 他 就是 缺考 零分 受 的 分 是 他 答满 的 分 倒数 第一 和 第二
攻 把 卷子 写受 的 名字 他 就是 缺考 零分 受 的 分 是 他 答满 的 分 倒数 第一 和 第二	大武 真的 爱 吃 鸡 咯咯 哒 回复 大武 真的 爱 吃 鸡 咯咯 哒 败家 老爷们儿 说 的 就是 攻
奶茶 奶茶 奶茶 奶茶 奶茶	图片 评论
图片 评论	图片 评论
我 期待	谢谢 超爱亲 画 的 头
谢谢 超爱亲 画 的 头	共勉
求问 普肌 是 像 普 还是 普 啊	偏普
偏普	关注
会 有 浅 烧 吗	那 必须 的 暂定 就是 浅烧 和 普
那 必须 的 暂定 就是 浅烧 和 普	蹲 蹲 蹲
哈哈哈哈 值得	祝 亲爱 的 大麦
祝 亲爱 的 大麦	啵 啵 啵 爱 你
辛苦 啦 注意 身体 啊	谢谢 大 宝贝 我 马上 去 补眠 了
谢谢 大 宝贝 我 马上 去 补眠 了	快 去 睡 吧 晚安
都 好看 啊 嗷嗷 第一套 我 也 喜欢	嗯 嗯 我 到时候 去 月 晓 摊子 看看 实物 去
嗯 嗯 我 到时候 去 月 晓 摊子 看看 实物 去	好 的 呀 亲爱 的 也 看看 有没有 适合 将来 拍官 图 的 衣服 什么 的
好 的 呀 亲爱 的 也 看看 有没有 适合 将来 拍官 图 的 衣服 什么 的	嗯 嗯 我 也 是 这么 打算 的 到时候 用 几套 搞个 混 搭
嗯 嗯 我 也 是 这么 打算 的 到时候 用 几套 搞个 混 搭	好 的 呀 我 现在 觉得 混搭超 好玩 就是 收拾 起来 得多叠 好几套 衣服
狗屎 真的 是 颜值 担当 狗屎 放心 飞屎 骑永 相随	哈哈哈哈 哈哈哈哈 哈哈哈 哈哈哈 屎 骑 是 什么 听 起来 好 恶心 啊
哈哈哈哈 哈哈哈哈 哈哈哈 哈哈哈 屎 骑 是 什么 听 起来 好 恶心 啊	你 居然 侮辱 我们 狗屎 粉丝 的 尊称 你 一定 要 这样 对待 我们 爱豆 吗 不要 以为 打压 了 我们 爱豆 你 就 可以 成为 我 的 最 爱 我 告诉 你 你 只能 是 我 的 第二个 最 爱
太太 双道 长 什么 时候 才 开网 贩	后 吧
后 吧	太太 你 真的 开网 贩 么 开 的话 我 就 等 玉虚 黑 道长 了
太太 你 真的 开网 贩 么 开 的话 我 就 等 玉虚 黑 道长 了	后面 会 有 掉落 可以 关注 微 博会 发 的
后面 会 有 掉落 可以 关注 微 博会 发 的	好 的 太太 那 我 就 等 玉虚 黑 道长 了 默默 再 问 一句 有 壮叔 尺寸 吗
好 的 太太 那 我 就 等 玉虚 黑 道长 了 默默 再 问 一句 有 壮叔 尺寸 吗	有 的
有 的	谢谢 太太
谢谢 太太	啊 脸 疼 哈哈哈
啊 脸 疼 哈哈哈	那 就 换个 不 疼 的
还有 太太 叔 应该 选 哪个	胸围 多少
胸围 多少	好 的 太太 让 我 先 想想 是 接 道长 还是 圆领 袍
嘿嘿 爱 你	么 么 么
么 么 么	啪啪 啪
哈哈哈哈 你 的 喵 姐 吗 黄色 啥 外观	做 任务 得 的 什么 时候 给 我 传功 阿 搓手
做 任务 得 的 什么 时候 给 我 传功 阿 搓手	你 上线 喊 我 呀
你 上线 喊 我 呀	今晚 点 呢 ?
今晚 点 呢 ?	我 已经 下 了 明天 约
我 已经 下 了 明天 约	赶 了 明天 要交 的 两份 作业 然后 现在 打开 了 电脑
赶 了 明天 要交 的 两份 作业 然后 现在 打开 了 电脑	明天 早上 没课 中午 上 一会
明天 早上 没课 中午 上 一会	一上午 都 没课 ?
一上午 都 没课 ?	对
对	我们 明天 都 有 课
这个 图神 他 妈 哈哈哈 哈哈哈 我闭 着眼 选 的 叶修	我 也 觉得 略 丑
我 也 觉得 略 丑	就是 麦乐卡 那套 我 真是 我叶粉 都 没 买 他 太
万圣节 去 了 一次 吓 得 完全 不敢 进 嗷嗷 太太 好 厉害	万圣节 好多 吓人 的 东西 吧
万圣节 好多 吓人 的 东西 吧	买票 进去 参观 门口 超 害怕
买票 进去 参观 门口 超 害怕	门口 有 灯光 还 能 看到 全貌 再 里面 很多 像 坟包 半盏 灯 都 不 给 大 晚上 的 清明 又 到 了 听说 万圣节 有 扮鬼 蜘蛛 玩具 什么 的
先 回来 两天 再 去	对 啊 放假 了 我 在家 了
对 啊 放假 了 我 在家 了	哈哈哈 哈哈 我 忘记 放假 了
哈哈哈 哈哈 我 忘记 放假 了	你们 也 放假 了 不是 吗
你们 也 放假 了 不是 吗	放假 了 等于 没 放假
放假 了 等于 没 放假	还是 要 还 的
腻害 了	痛苦
痛苦	好些 没有
好些 没有	好 一些 了
我 又 和 寝室 们 的 去 吃 了 米线 煮艺 我 没 吃 完 其实 我 不 饿 的 真的 好喝 耶	浪费 我 辛辛苦苦 带 回来 的
浪费 我 辛辛苦苦 带 回来 的	我 是 说 米线 没 吃 完 不 那么 想 吃 米线
我 是 说 米线 没 吃 完 不 那么 想 吃 米线	这 还 差不多
阿清	这 句子 咋断
这 句子 咋断	反正 就是 长青
如果 现在 再 组织 一次 我能 弄 得 更好	那 你 组织 去 柬埔寨 吧
那 你 组织 去 柬埔寨 吧	去 一次 泰国 倒 是 可以 组织 组织
错过 了 一个亿	不 知道 谁 吃 多 了 菠萝
不 知道 谁 吃 多 了 菠萝	怪 我 罗
最 恶心 的 是 营销 手段 几百块 钱 的 玩意儿 我们 不能自己 买来 开心 非要 让 直 男 送 才 显得 你 是 小 公主 简直 到 鞋底	约 不
约 不	略略 略
是 的	她 还是 那么 常驻 就 好 了
她 还是 那么 常驻 就 好 了	九十六 了 吧 估计 累背 不了 太 多 台词
十九岁 的 你 会 更 优秀	好 的 栗子 小可爱
好 的 栗子 小可爱	么 么 哒
请问 车灯 怎么 打开 啊	小白 没有 车灯
小白 没有 车灯	所以 车头 那灯 是 好看 用 的 吗
所以 车头 那灯 是 好看 用 的 吗	反光板 啊
反光板 啊	那 只 适用 于 对面 有 车灯 照过来 吧 没有 路灯 没有 车辆 过来 就 没 啥 用 了
那 只 适用 于 对面 有 车灯 照过来 吧 没有 路灯 没有 车辆 过来 就 没 啥 用 了	是 的 有 车灯 的 只有 公共 自行车 小 黄人
男 的 女 的 都 不要脸 吧	女 的 不要脸 男 的 还好 要是 我 女儿 一巴掌 打死
女 的 不要脸 男 的 还好 要是 我 女儿 一巴掌 打死	男 的 女 的 一起 的 还 只有 女 的 不要脸
男 的 女 的 一起 的 还 只有 女 的 不要脸	男 的 骑车 姿势 正常 啊
好 尴尬 哦	不 接电话
不 接电话	我 晚上 到 到 时 联系
爬山 累 吗	飞机 降落 快 吐 了 还 没缓 过来
飞机 降落 快 吐 了 还 没缓 过来	你 没 吃 晕车药 吗
你 没 吃 晕车药 吗	我 回去 的 时候 吃 晕 安眠药
你 竟然 不 害怕 鸡 爪子 了	我 本来 就 不 害怕 鸡 爪子
我 本来 就 不 害怕 鸡 爪子	那 你 是 害怕 鸡
那 你 是 害怕 鸡	对 啊 我 打死 你 喔
哈哈哈 哈哈哈	你 也 有
你 也 有	哈哈哈 哈哈 都 是 好 哥哥
真 羡慕 长得 好看 的	真 不 好看 姐姐 说 可爱 勉强 接受 好看 不行 哈哈哈
真 不 好看 姐姐 说 可爱 勉强 接受 好看 不行 哈哈哈	味道 是 甜甜的
味道 是 甜甜的	哈哈哈 哈哈哈 哈哈哈 这个 可以 的
好看	哈哈哈 小可爱 晚安
哈哈哈 小可爱 晚安	晚安
昨天 说 了 做 大哥 的 女人	哈哈哈哈 大哥 好 大哥 辛苦 了
哈哈哈哈 大哥 好 大哥 辛苦 了	挑眉
我 最近 都 中 它 的 毒 了	哈哈 我 也 非常 爱
哈哈 我 也 非常 爱	是 的 很 好吃 呀
你 有 他 的 表情 居然 不 给 我	我 明明 发给你 了 你 有没有 认真 和 我 聊天
我 明明 发给你 了 你 有没有 认真 和 我 聊天	没有 证据 拿来
这 不是 你昂 . 你 怎么 会 摆 这么 做作 的	我 就 叫做 作
我 就 叫做 作	你 的 衣服 我们 都 没见 过 啊
你 的 衣服 我们 都 没见 过 啊	是不是 很 美
是不是 很 美	那 就 美 吧
那 就 美 吧	谢谢 你 柔柔 你 真 善良
谢谢 你 柔柔 你 真 善良	希望 你 和 爱 的 人 在 一起 我 最 想 看到 我 的 小 天线 幸福
希望 你 和 爱 的 人 在 一起 我 最 想 看到 我 的 小 天线 幸福	希望 小舅舅 听到 我 内心 的 呼唤
刚 把 爹	好 的 敏敏 还有 我 觉得 我 可以 做 你 的 日本 导游 了 嘻嘻
好 的 敏敏 还有 我 觉得 我 可以 做 你 的 日本 导游 了 嘻嘻	好棒
好棒	哈哈 比心
忒 棒	吗 再接再厉
吗 再接再厉	再接再厉
小 本本 记下来	从 武汉 都 开始 了 夸 我
从 武汉 都 开始 了 夸 我	那 你 很 棒棒 诶 给 一朵 小花
那 你 很 棒棒 诶 给 一朵 小花	收 了
收 了	想起 了 我 那 一打 高铁 票
想起 了 我 那 一打 高铁 票	哇 你 那 就是 来回 学校 家家 学校 的
哇 你 那 就是 来回 学校 家家 学校 的	不行 我 也 要 翻 一个
不行 我 也 要 翻 一个	哈哈哈 哈哈 不 和 你 争
哎 我 发现 你 拍照 水平 越来越 好 了 耶	是 的 吧 哇 朝洋 等 我 见 你 了 传授 一下 给 你
是 的 吧 哇 朝洋 等 我 见 你 了 传授 一下 给 你	哈哈 这个 就 非常 有 必要 了
哈哈 这个 就 非常 有 必要 了	还有 普通话 不 客气
附近 有家 很小 的 包子 店 是 我 吃 过 最 好吃 的 包子	说 说 可能 就是 我 吃 的 那家
说 说 可能 就是 我 吃 的 那家	我 不 记得 名字 了 很 普通 的 店面 但是 早上 很多 人 排队
不 穿衣服 的 风格	挺 好看 的 买 了 吧
挺 好看 的 买 了 吧	您 现在 说 还 来得及 吗
您 现在 说 还 来得及 吗	你 发 的 太晚 了
你 发 的 太晚 了	早点 发保 不准 就 被 你 忽悠 了
早点 发保 不准 就 被 你 忽悠 了	睡觉 睡觉
睡觉 睡觉	睡 什么 睡 起来 嗨 吖
买回来	太大 了
太大 了	多少 码
多少 码	裤子 大 了 衣服 应该 也 是 也 大 了 这 码数 有毒 .
你 再 和 我 说 你 胖	照片 都 是 骗人 的 你 又 不是 不 知道 我 肚子
照片 都 是 骗人 的 你 又 不是 不 知道 我 肚子	宝宝 你 看 你 第二张 图 的 腿 都 快成 厌食症 患者 了 为什么 不能 图片 评论
宝宝 你 看 你 第二张 图 的 腿 都 快成 厌食症 患者 了 为什么 不能 图片 评论	应该 是 裤筒 太大 了 对比 效果 我 也 不 知道 为什么 不能 图片 评论 哇 我 去 研究 研究
应该 是 裤筒 太大 了 对比 效果 我 也 不 知道 为什么 不能 图片 评论 哇 我 去 研究 研究	我要 催 你 多 吃 点 饭 快快 长大
我要 催 你 多 吃 点 饭 快快 长大	我 今天 中午 三点 吃 的 海底 捞 六点 又 去 吃 了
我 今天 中午 三点 吃 的 海底 捞 六点 又 去 吃 了	夜宵 吃 什么
夜宵 吃 什么	糯米鸡 吧 还有 猪 耳朵
糯米鸡 吧 还有 猪 耳朵	记得 等 我们 来 的 时候 准备 好 一桌 菜
你 妈 的 是不是 你 设置 不能 图片 评论	没 啊 我 设置 个 毛 啊 为啥 不能
没 啊 我 设置 个 毛 啊 为啥 不能	不知
哇 美女	宝贝 你 言重 了 我 这 一看 就是 照骗
宝贝 你 言重 了 我 这 一看 就是 照骗	我 知道 你 在
我 知道 你 在	被 你 发现 了 是不是 全国 的 试衣间 里 的 鞋子 都 一个样
看看 他 女朋友 和 他 的 合照 就 更 感慨 了	昨天 我 竟然 梦见 我 和 他 女朋友 是 好 朋友 好开心 啊 这样 我 也 可以 和 他 是 好 朋友 了
昨天 我 竟然 梦见 我 和 他 女朋友 是 好 朋友 好开心 啊 这样 我 也 可以 和 他 是 好 朋友 了	天 哪 现实 中快 出现 一个 这样 的 男生 来 拯救 你 吧
海街 日记	啊 对 哇 你 看 没 看 没
啊 对 哇 你 看 没 看 没	还 没什么 时候 趟 床上 慢慢 看
有 滤镜 找 不到 是 为什么	需要 买 滤镜 的
需要 买 滤镜 的	怎么 买
怎么 买	淘宝
我 的 滤镜 为啥 不全 啊	要 买 淘宝 白菜价
要 买 淘宝 白菜价	好 的 谢谢 哈
哈哈 难道 你 是 陕西 的 考生	是 啊
是 啊	嗯 啦 一样 你 陕西 哪里 的 呀
嗯 啦 一样 你 陕西 哪里 的 呀	西安 你 呢
西安 你 呢	我 在 汉中 也 不 知道 这次 职位 怎么样 我 的 专业 不是 很 好 报 有点 担心
我 在 汉中 也 不 知道 这次 职位 怎么样 我 的 专业 不是 很 好 报 有点 担心	我 专业 也 偏好 焦急 还 不出 我 太 不 淡定 了
我 专业 也 偏好 焦急 还 不出 我 太 不 淡定 了	再 等等 吧 我 估计 也 就是 天 左右 吧 虽然 没有 参加 过省 考 但是 看题 我 感觉 陕西 题 很多 申论 也 多 都 不 知道 能 不能 做 完
再 等等 吧 我 估计 也 就是 天 左右 吧 虽然 没有 参加 过省 考 但是 看题 我 感觉 陕西 题 很多 申论 也 多 都 不 知道 能 不能 做 完	申论 时间 充足 三个 小时 呢 行测 紧张
申论 时间 充足 三个 小时 呢 行测 紧张	谢谢 啦 我 说 申论 那么 多题 我 以为 个 小时 一起 加油
辽宁 也 未出 就是 这么 屌	为何 都 如此 淡定
为何 都 如此 淡定	据说 招 的 也 很少 未必 有岗
姐姐 早	厉害 了 乖乖 早
厉害 了 乖乖 早	姐姐 睡 吧 安
姐姐 睡 吧 安	安 啦
靳东 靳东 外科 风云 来 了 爱东 从 小事 做起	岽 游记 靳东 靳东 从 点点滴滴 的 小事 做起
岽 游记 靳东 靳东 从 点点滴滴 的 小事 做起	靳东 靳东 外科 风云
好像 没有 播完	对 一帮人 同偕到 老 不靠 运气
对 一帮人 同偕到 老 不靠 运气	一个 超长 音在试 了 一遍 才 知道 吼 也 是 要 有 技术 的
第一张 用 的 什么 图 软件 好 喜欢	美图秀 秀 马赛克
美图秀 秀 马赛克	玩 了 一下 好 好玩 成功 美图秀 秀 的 另 一 功能
玩 了 一下 好 好玩 成功 美图秀 秀 的 另 一 功能	是 的 开始 还好 嫌弃 美图秀 秀 没什么 好 的 功能 突然 发现 这 马赛克 不错
多 多喝水	还是 巨 难受
还是 巨 难受	你 得 去 看看 我 前年 胃肠 疾病 没当回事 第二天 晕倒 两次 差点 过去 别 忽视
拍照 技术 棒棒 哒	谢谢
谢谢	你 关注 我
你 关注 我	来 呀 来 呀 互相 伤害
这个 地方 我 知道	你 去过
你 去过	自 对外开放 的 时候 就 想 去 一直 腾 不 出来 时间
自 对外开放 的 时候 就 想 去 一直 腾 不 出来 时间	找个 时间 来 吧
找个 时间 来 吧	现在 在 小寨
现在 在 小寨	离 我 这么 近
离 我 这么 近	是不是 啊
是不是 啊	是 啊
我 也好 想 去	我 觉得 特别 适合 文青 比如 你
我 觉得 特别 适合 文青 比如 你	可惜 我 没有 机会 去
可惜 我 没有 机会 去	你 肯定 有 的
你 肯定 有 的	可以 可以
我 此时 也 想 给 你 发个 定位	难道 你 回老家 了
难道 你 回老家 了	对 呀
我们 学校 花开 了	节后 去
节后 去	你 要 现在 去 我 也 不 在 学校
去 哪里	回家
回家	好 吧 我 还 在 上班
好 吧 我 还 在 上班	加班 你 太 辛苦 了
加班 你 太 辛苦 了	我 也 很 委屈
我 也 很 委屈	权当 不去 看 人 多 了 份 安静 这样 安慰 自己
若 是 手指 在 修长 一些 会 更好 看	我 也 希望 有 双 弹钢琴 的 手 可惜 没有
我 也 希望 有 双 弹钢琴 的 手 可惜 没有	愿 你 早日 有 一双 自己 的 假肢
愿 你 早日 有 一双 自己 的 假肢	假肢 就算 了
假肢 就算 了	你 忘 了 今天 是 一个 特别 的 日子
你 忘 了 今天 是 一个 特别 的 日子	差点 忘 了
差点 忘 了	我 就 笑笑
尤其 是 在 知道 自己 是 大摩 羯 之后	摩 羯 是 排 在 天蝎 后面 的 第二 好 都 不行 吗
摩 羯 是 排 在 天蝎 后面 的 第二 好 都 不行 吗	呵呵 活该 你 孤独 终老
呵呵 活该 你 孤独 终老	你 这善妒 的 女人
你 还 真是 足够 关注 我	没事 瞅 两眼
没事 瞅 两眼	谢主 隆恩
哦 哟	我 竟然 才 看见 你 这条 贱 兮兮 的 评论
我 竟然 才 看见 你 这条 贱 兮兮 的 评论	假如 给 你 三天 光明
假如 给 你 三天 光明	那 我 岂 不是 要 被 自己 美翻 了
咋 的 了	给 你 欠儿 的
给 你 欠儿 的	揍 你 哦
晚上 出来 撸 串子 讲讲 你 阻碍 现在 幸福 的 幸福 回忆	有人 以前 不 只是 有心 也 会 付出 实际 现在 却 只是 有心 了
有人 以前 不 只是 有心 也 会 付出 实际 现在 却 只是 有心 了	我 觉得 你 说 的 不是 我
我 觉得 你 说 的 不是 我	对 啊 这种 事一看 就 不是 你 风格
没 能 通过 体检 一直 都 很 难过	我 也 是
我 也 是	虽然 遗憾 但 加油 吧
虾米 音乐 不要 钱	虾米 是 听 五月天 的
虾米 是 听 五月天 的	我充 了 虾米 会员 她 的 歌全 可以 下 诶
我充 了 虾米 会员 她 的 歌全 可以 下 诶	我 试试
听歌 付费 这个 事情 真的 蛮 好 的 中国 人太 没 版权 意识	所以 要 改 啊 这样 真的 不好 也 该 进步 了 花 几块钱 听到 别人 的 心血 没 毛病 啊
所以 要 改 啊 这样 真的 不好 也 该 进步 了 花 几块钱 听到 别人 的 心血 没 毛病 啊	你 说得对 我 还是 觉得 不要 版权 好 毕竟 各种 抢 手机 需要 下 很多 听歌 的 软件 才 可以 听想 听 的 人 的
你 说得对 我 还是 觉得 不要 版权 好 毕竟 各种 抢 手机 需要 下 很多 听歌 的 软件 才 可以 听想 听 的 人 的	下载 软件 只是 市场竞争 问题 以后 一个个 淘汰 就 好 了 版权 真的 很 重要 啊 现在 中国 影视 综艺 这么 粗制滥造 很大 一部分 就是 因为 没有 版权 意识 各种 抄袭 不会 原创
下载 软件 只是 市场竞争 问题 以后 一个个 淘汰 就 好 了 版权 真的 很 重要 啊 现在 中国 影视 综艺 这么 粗制滥造 很大 一部分 就是 因为 没有 版权 意识 各种 抄袭 不会 原创	现在 跑步
现在 跑步	哈哈 加油
小 苇草 君 后者 但 买不起 北京 房 的 不止 你 一个 留不住 女朋友 的 也 不止 你 一个 因为 男朋友 买不起 房而 分手 的 肯定 不止 你 一个 放宽心	哈哈 其实 我 都 忘记 了 今天 刷 微博 突然 看到 了 这个 话题 谢谢 哈
哈哈 其实 我 都 忘记 了 今天 刷 微博 突然 看到 了 这个 话题 谢谢 哈	别 心痛 啦 赶紧 走 出来
别 心痛 啦 赶紧 走 出来	她 早就 死 在 我 的 世界 了
是 时候 教教 你 针线活 了	手把手 教
手把手 教	别 不用
总 有人 问 如果 我们 早 一些 或者 晚一点 遇到 如果 是 另 一个 人 如果 当初 做 了 其它 的 选择 是不是 会 更好 不会 眼前 最好 当下 最好 惺惺相惜 最好 拥有 的 最好 你	棒棒
棒棒	小 傻瓜 儿
已有 谢谢	我 有 内场 一排 不是 黄牛 带走
我 有 内场 一排 不是 黄牛 带走	你 简直 就是 个 台柱子
你 简直 就是 个 台柱子	不 客气 谢谢
这 是 啥 电脑	不错
不错	碎成 渣 了 都
碎成 渣 了 都	能 开机 不 凑合着 用
能 开机 不 凑合着 用	能 开机 就是 屏和壳 碎成 狗 了
能 开机 就是 屏和壳 碎成 狗 了	挺住 坚强
姐 你 这 蜡烛 哦 很 好看	每 一根 都 代表 了 我 的 痛心 港真 你 不然 和 同学 合计 合计 找个 房子 搬出去 住 算了 甲醛 要命 啊
每 一根 都 代表 了 我 的 痛心 港真 你 不然 和 同学 合计 合计 找个 房子 搬出去 住 算了 甲醛 要命 啊	也 是 奇 了 怪 了 甲醛 还 能 过敏 姑姑 让 我 明天 做个 血常规 化验
也 是 奇 了 怪 了 甲醛 还 能 过敏 姑姑 让 我 明天 做个 血常规 化验	嗯 健康 还是 要 好好 重视 的 加油 加油
嗯 健康 还是 要 好好 重视 的 加油 加油	加油 加油 健康 确实 最 重要
你 看 的 是 如何 征服 一个 女生 的 书吧	越来越 不会 说话 了
越来越 不会 说话 了	明明 就是 真话
这波 狗 粮 我 不吃	啊 张嘴 我 喂给 你
啊 张嘴 我 喂给 你	我 只会 踢翻 你 给 我 的 狗 粮
我 只会 踢翻 你 给 我 的 狗 粮	你 这 反射弧 也 太长 了
你 这 反射弧 也 太长 了	该 我 你 还 懂 反射弧
该 我 你 还 懂 反射弧	懂 一点
景比人 好看	出 问题
出 问题	没 呀
照顾 好 自己 好好 生活	夏天 你 也 是 夏天 的 时候 夏天 再见
夏天 你 也 是 夏天 的 时候 夏天 再见	好 的
结局 太 恐怖 了	是 个 段子
是 个 段子	没看 懂
扎心 了 老铁	怎么 了
怎么 了	蓝过 蓝 瘦 香菇
蓝过 蓝 瘦 香菇	这么 惆怅 呢
堵人	滚呐
滚呐	哇
心疼 你	那 就 来 兰州 看 我 啊
那 就 来 兰州 看 我 啊	不要 太远 了
不要 太远 了	等 我 下次 来看 你 吧
等 我 下次 来看 你 吧	你 来 了 和 我 去 敦煌 玩儿 机不可失
你 来 了 和 我 去 敦煌 玩儿 机不可失	啥时候
啥时候	清明 或者 .
清明 或者 .	你 几个 人
一起 一起 打	我微 信区
我微 信区	我 也 微信
我 现在 还 在 写 也 不 知道 要 写 到 啥时候	哈哈哈哈 哈哈哈哈 我 写 完 了 哈哈哈 哈哈哈 哈哈哈 我要 开 一局 游戏 睡 了 哈哈哈 哈哈哈 哈哈哈
哈哈哈哈 哈哈哈哈 我 写 完 了 哈哈哈 哈哈哈 哈哈哈 我要 开 一局 游戏 睡 了 哈哈哈 哈哈哈 哈哈哈	我 先 把 游戏 下 回来
咋 了 老铁	感冒
感冒	老铁不铁 啊
老铁不铁 啊	再 铁 啥 呢
真的	让 你 瞎 优雅 还 买 茶具 这种 易碎品 你 要 当面 查收 笨
让 你 瞎 优雅 还 买 茶具 这种 易碎品 你 要 当面 查收 笨	你 早 不 给 我 说 么
生日快乐 老铁	谢谢
谢谢	不用谢
不用谢	不要 谢谢
肯定 好看	你 凭 啥 这样 说
你 凭 啥 这样 说	身高 颜值
身高 颜值	去 了 国外 眼水 提高 了 啊
去 了 国外 眼水 提高 了 啊	记得 带 一个 嗲 嗲 的 男朋友 回来
记得 带 一个 嗲 嗲 的 男朋友 回来	天惹 我 才 不好 这口
天惹 我 才 不好 这口	不要 不好意思 嘛
你 终于 想开 了	出家 了
出家 了	没 地方 接纳 你 吧
没 地方 接纳 你 吧	只是 觉得 理发师 不错 剪 的 好 圆
嘴里 藏 东西 了 吗	么 木
么 木	图一 那 一 坨 肉 怎么回事
图一 那 一 坨 肉 怎么回事	扭曲 了 吧 我 也 不 知道
跟 你 说 吼 专 我 也 抽到 了 小 裴 所以 就 不能 跟 你 换 啦	啊 没事 啦
啊 没事 啦	跟 你 说 一声 下次 有 机会 再换
这是 哪次 公演 俊俊 降落伞 嘛	的 公演
的 公演	感谢
确认 了 一下 应该 不是 同 一位 拉迪迪手 旁边 的 哥哥 应该 才 是 系 领带 的 吧 好像 不太 确定	你 说 白 外套 那个 吗 那个 不像 啊
你 说 白 外套 那个 吗 那个 不像 啊	这儿 也 是 脸盲 不过 每个 哥哥 看到 真的 奶 的 孩子 肯定 都 想 揉 两下 哈哈哈
这儿 也 是 脸盲 不过 每个 哥哥 看到 真的 奶 的 孩子 肯定 都 想 揉 两下 哈哈哈	你 说 的 对 不想 猜 了 眼睛 疼
. 養成記 了	你 看 他俩 的 手 . 我 的 天 啦
你 看 他俩 的 手 . 我 的 天 啦	对比 了 一下 侧脸 应该 就是 他 了 .
对比 了 一下 侧脸 应该 就是 他 了 .	如果 兩個 都 進 的 話 我 在 狗 這對
这 是 谁 的 爪子 哈哈哈哈	猫猫 的
猫猫 的	哈哈哈 想 做 你家 会 弹琴 的 喵
水立方 有个 包青天	开封 尉氏县 水立方 一帮 杂碎 缺 一个 包青天
开封 尉氏县 水立方 一帮 杂碎 缺 一个 包青天	哪 都 缺
控制 自己 的 一般 不是 人	控制 不住 怎么办 捏
控制 不住 怎么办 捏	凉拌 就 好 了 呀
可以 拍 今年 的 快 男	有 介绍 吗
有 介绍 吗	我 就是 哈哈哈哈
我 就是 哈哈哈哈	约 一波
希望 来 长沙	五月 草莓 音乐节 不是 来 嘛
五月 草莓 音乐节 不是 来 嘛	那 是 橘子洲 音乐节 吧 草莓 五月 也 来 长沙
那 是 橘子洲 音乐节 吧 草莓 五月 也 来 长沙	呢 就是 橘子洲 音乐节 记错 了
我 今天 为了 挑 一个 好 的 小 黄 车费 了 很 长时间	哈哈 是 太少 吗
哈哈 是 太少 吗	不少 就是 我 太 挑
你 年 赞过 了	哥 又 赞 了 一次
哥 又 赞 了 一次	是 啊 哈哈
必须 的	谢谢 支持
谢谢 支持	应该 的
這個 也 超經典 我 的 無間 無間 無間 無間 無間 道	为什么 经典 的 都 要 跟 会长 有点 关系
为什么 经典 的 都 要 跟 会长 有点 关系	真的 還有 什麼 林北什麼 都 也 是 會長 哈哈哈 還有 好人 卡
真的 還有 什麼 林北什麼 都 也 是 會長 哈哈哈 還有 好人 卡	笑 死 我 啦
在 哪 看 武汉 台 啊 爹	你 去 网上 直播 搜 看看 能 看到 不
你 去 网上 直播 搜 看看 能 看到 不	好 嘞
上 金星 秀 了 吗	节目 都 录 完 了 就 等 着 播 了
节目 都 录 完 了 就 等 着 播 了	哇 太棒了 我 盼 这个 盼 了 好久 耶
两会 停播 两个 星期 又 赶上 要 宣传 电影 先播 后面 的 嘉宾 没想到 一等 就是 五个 星期 我 的 内心	压轴 也 就 只能 这么 安慰 自己 了 等 的 我 花都 谢 了 也 不播
压轴 也 就 只能 这么 安慰 自己 了 等 的 我 花都 谢 了 也 不播	希望 轩哥 后面 是
希望 轩哥 后面 是	可 别 赶上 清明节 希望 能 尽早 播 吧
每个 周都 看 一下 节目表	这个 月 不用 看 了 看 完 还 会 接着 失望
这个 月 不用 看 了 看 完 还 会 接着 失望	好 的 老板 听 你 的
说 我 是不是 你 的 好 老公	不是
不是	去 你 外婆家 的 香蕉皮
去 你 外婆家 的 香蕉皮	这句 话 好 耳熟
四月 去 哪 玩 游记 美	晚上 好 艾君小梁 县长 南宁 周边游
晚上 好 艾君小梁 县长 南宁 周边游	晚上 好
苦 逼 看书	学霸 好
学霸 好	也 是 被 逼 的 啊
是 看 上 什么 了	看上 我 头像
看上 我 头像	钛合金 瞎 了
什么游戏	全职 高手 的 手游 啊 正在 内测
全职 高手 的 手游 啊 正在 内测	坐等
永不 消逝 的 电波 之前 不是 说 五月 一日 上映 吗 又 又 又 延 了	之前 只是 據 製 片 方 聽 聞 是 在 五一 檔並 不 代表 就是 月號 這個 常識 已經 說過 了 現 在 有 可能 會 有 一些 變化 所以 讓 包括 電波迷 在 內 的 廣大 影迷 朋友 互動 一下 就是 為 了 好玩 嘛 當然 也 看看 誰 有 運氣 了
之前 只是 據 製 片 方 聽 聞 是 在 五一 檔並 不 代表 就是 月號 這個 常識 已經 說過 了 現 在 有 可能 會 有 一些 變化 所以 讓 包括 電波迷 在 內 的 廣大 影迷 朋友 互動 一下 就是 為 了 好玩 嘛 當然 也 看看 誰 有 運氣 了	哦 谢 啦
博主 跟 我 站 同一 对 那 咱们 以后 就是 过命 的 好 兄弟 了 真的 好 希望 他们 俩 合作 一部 现代戏 拍成 啥 样多 狗血 我 都 吃	偷摸 的 说 我 也 这样 想
偷摸 的 说 我 也 这样 想	而且 私下 觉得 赵丽颖 跟 陈伟霆 一点 都 不配 邪 魅 狷 狂 霸道 总裁 怎么 能配 傻 白甜 呢 就 应该 配艳若 玫瑰 的 妩媚 佳人 啊
而且 私下 觉得 赵丽颖 跟 陈伟霆 一点 都 不配 邪 魅 狷 狂 霸道 总裁 怎么 能配 傻 白甜 呢 就 应该 配艳若 玫瑰 的 妩媚 佳人 啊	嘿嘿 老 姐姐 粉 觉得 他 两个 蛮 有 夫妻 相 的 热 吧 比较 娇俏 可爱 我 很 喜欢 她
那个 是 丁 隐丁隐 不是 有 刘海 了	长老 隐和血 魔 没 钢丝 球 刘海
长老 隐和血 魔 没 钢丝 球 刘海	没 刘海 好帅 哦
任小满 余墨 残香 独自 敛 胡家小 殊有 粮 了	图片 评论
图片 评论	一起 吃个 久违 的 粮
一起 吃个 久违 的 粮	也 非常 开心 了
也 非常 开心 了	哈哈哈 哈哈 自抱 自泣
留个 言	回复 下
回复 下	哈哈哈 很萌 了
虐 了	什么 时候 甜过
什么 时候 甜过	也 对
荨 懵 我 也 要	那 你 来 呀
那 你 来 呀	五月份 咯
五月份 咯	太晚 了 不 等 你
多少 钱	你 要 哪个
你 要 哪个	什么 价
看到 了 你 的 用心 真 好	真的 吗 你 去 了 吗 他 说 喜欢
真的 吗 你 去 了 吗 他 说 喜欢	没有 没有 我 没有 那么 好运 啦 反正 你 的 用心 我 是 看到 啦 你 男神 也 一定 会 知道 哒
没有 没有 我 没有 那么 好运 啦 反正 你 的 用心 我 是 看到 啦 你 男神 也 一定 会 知道 哒	谢谢 宝宝 比心
墙头 果然 好多	这 还 只是 一部分 哈哈哈 偶尔 还会 舔 屏 别的 凤 最 好吃 因为 我 是 陆 小鸡 万年 迷妹
这 还 只是 一部分 哈哈哈 偶尔 还会 舔 屏 别的 凤 最 好吃 因为 我 是 陆 小鸡 万年 迷妹	我 是 花花 的 花痴 粉
我 是 花花 的 花痴 粉	哼 抱 走 小鸡
曾 轶 可 的 粉 你 要 不要 粉	粉 你 啦 我 看过 好 妹妹 北京 那个 演唱会 不过 我粉 的 很 路 人
粉 你 啦 我 看过 好 妹妹 北京 那个 演唱会 不过 我粉 的 很 路 人	木马 木马
啧啧 啧想 听	来 这 就 发 你
来 这 就 发 你	不太好 吧
哈哈哈 哈哈哈 瘦 的 反义词 胖	你 最 胖
你 最 胖	谢谢
谁 知道 栋哥 今晚 还 上 不 上线	他 上 不 上线 有 啥 关系 吗
他 上 不 上线 有 啥 关系 吗	他 什么 时间 上线 我 好 关注 啊
期待 哦 御姐 什么 时候 可以 听到 自己 喜欢 的 歌 看到 喜欢 的 人 呢	看命
看命	我 不 看命 看 你
我 不 看命 看 你	看 我 干 啥
看 我 干 啥	好 听的歌 好看 的 人 你 懂 的
好 听的歌 好看 的 人 你 懂 的	哈哈哈 好好
哈哈哈 好好	一直 等 哦
好看 吗	我 觉得 挺 好看 准备 明天 二刷 去
我 觉得 挺 好看 准备 明天 二刷 去	哈哈哈 那 我 也 去 看看
哈哈哈 那 我 也 去 看看	去 看 之前 你 可以 先 去 看看 金刚 年 的 看 你 喜不喜欢
去 看 之前 你 可以 先 去 看看 金刚 年 的 看 你 喜不喜欢	金刚 不是 猩猩 吗
金刚 不是 猩猩 吗	是 呀 你 会 喜欢 他 的
月 半 的 好像 人数 不够	好像 早就 够 了
好像 早就 够 了	那 是因为 啥 呢 没 开通
那 是因为 啥 呢 没 开通	不 知道 反正 我 记得 人 就 够 了 有 可能 还要 去 超级 话题 微博下 申请 下
月 半 的 呢	不是 够 人 就 可以 吗
不是 够 人 就 可以 吗	人 那 差 不太多 了 吧
真 进不去 请问 用 什么 办法	可以 的 保存 图片 然后 发到 微信 的 文件传输 助手 然后 长 按 就 可以 加 了
可以 的 保存 图片 然后 发到 微信 的 文件传输 助手 然后 长 按 就 可以 加 了	我试 过 了 可以 但是 一百 人到 了 要 邀请
想 看栋哥 笑场	专业 演员
专业 演员	就是 啊 想 看 笑场 都 有点 困难
就是 啊 想 看 笑场 都 有点 困难	你 没 觉得 他 很 沉稳 吗
你 没 觉得 他 很 沉稳 吗	稳重 的 栋 哥 很 迷人 啊
稳重 的 栋 哥 很 迷人 啊	喜欢 的 就是 他 这种 性格
喜欢 的 就是 他 这种 性格	我们 都 中 了 栋 哥 的 毒 了 无解 啊
万里 独行 小 咸咸	暴露 本性 了 老 韩来 摸 我 脸 吧 我 绝对 不 躲
暴露 本性 了 老 韩来 摸 我 脸 吧 我 绝对 不 躲	想 不想 这样
想 不想 这样	不 只 想 这样
不 只 想 这样	超级 话题 里 聊天 要 低调 要 不 咱俩 私聊 可以 尽情
超级 话题 里 聊天 要 低调 要 不 咱俩 私聊 可以 尽情	哈哈哈哈 哈哈哈 你 的 配图 可 不够 低调
哈哈哈哈 哈哈哈 你 的 配图 可 不够 低调	你 可 满足
你 可 满足	好好 好
御姐 的 御 是 这个 你 挖出来 过 吗	没有 天 啊 好萌
没有 天 啊 好萌	是 吧 多 可爱
是 吧 多 可爱	萌 我 一脸 血
萌 我 一脸 血	你 现在 想 不想 这样 扑上去
你 现在 想 不想 这样 扑上去	自己 人
自己 人	我 突然 觉得 你 很快 要 变成 金 了
我 突然 觉得 你 很快 要 变成 金 了	为啥
为啥	因为 你 美
因为 你 美	好 吧 借 你 吉言 可是 金是 什么
好 吧 借 你 吉言 可是 金是 什么	就是 金色 的 认证 比如 其他 明星 的 那种
你 在 倒计时 吗	没错 因为 最近 没法 产出 只能 发 发旧 图
没错 因为 最近 没法 产出 只能 发 发旧 图	靠着 你 的 金榜 哥哥 过日子 了
这个 连接 可以 看 直播 吗 毕夏 全球 歌迷 后援会 毕夏贴 吧 歌迷会	能 看 回放 吗
能 看 回放 吗	应该 不能
蒋 敦豪	我 也 是 想 看 蒋 敦豪 在 哪里 能 看 回放 呢
我 也 是 想 看 蒋 敦豪 在 哪里 能 看 回放 呢	不 知道 啊 我 也 想 看 呢
几点 开始 呢 我 想 看 毕夏	晚上 点 开始
晚上 点 开始	好 的 一定 看 谢谢
好 的 一定 看 谢谢	客气 了
头像 好帅	没 你 的 帅
没 你 的 帅	比 我 这个 帅出 好几条 街 啦
比 我 这个 帅出 好几条 街 啦	哈哈哈 哈哈哈哈 那 倒 是
还好 我 没 回去 不然 你 遇见 我 也 叫 不 出来 名字 就 尴尬 了	我 还是 知道 你 叫 什么 的 那个 人 好像 是 你 开学 的 同桌
我 还是 知道 你 叫 什么 的 那个 人 好像 是 你 开学 的 同桌	刘一丹 彭志涛
刘一丹 彭志涛	刘一丹 吧 应该 是 的 记得 不清 了
我 有 巨蟹 男友	所以 你 会 幸福 加油 努力 维持 好
所以 你 会 幸福 加油 努力 维持 好	嗯 嗯
难怪 你 睡 了 我 不 给 我 名分	一夜情 听说 过 吗
一夜情 听说 过 吗	我 就 最烦 听 你 说话
我 就 最烦 听 你 说话	图片 评论
你 不 上班 啊	偷 着 跑
偷 着 跑	厉害 了 我 的哥 我 下午 也 偷 着 跑
厉害 了 我 的哥 我 下午 也 偷 着 跑	包场 了
包场 了	一大早 看 电影 的 只有 闲人
我 就 跪求 他少 打 酱油	打 酱油 好 呀 人设 都 超级 带感 他 这 不 叫 打 酱油 叫 客串 或者 特别 出演 又 轻松
打 酱油 好 呀 人设 都 超级 带感 他 这 不 叫 打 酱油 叫 客串 或者 特别 出演 又 轻松	他演 的 太 用心 然后 出现 那么 点 画面 我 就 各种 觉得 演太 认真 还 不 给 看够 好 亏欧
他演 的 太 用心 然后 出现 那么 点 画面 我 就 各种 觉得 演太 认真 还 不 给 看够 好 亏欧	钱不亏 就 好
钱不亏 就 好	对 这个 是 重点
想 做 时 再 做	可能 得 等 换 电脑 了 哈哈哈 哈哈
可能 得 等 换 电脑 了 哈哈哈 哈哈	电脑 不 给 力时 简直 想 砸 支持 你 等 换 电脑 再 做
电脑 不 给 力时 简直 想 砸 支持 你 等 换 电脑 再 做	穷 等 我 之后 把 电脑 清空 再 看 其实 还好 就是 预览 框 不 顺畅 然后 视频 大 了 有时候 会 无 响应 .
穷 等 我 之后 把 电脑 清空 再 看 其实 还好 就是 预览 框 不 顺畅 然后 视频 大 了 有时候 会 无 响应 .	开心 最 重要
我 也好 累 咋办	葛优 瘫
葛优 瘫	烦躁
烦躁	图片 评论
随手 挂 一个 智障	友尽 三分钟
友尽 三分钟	三分钟 到 了
我 昨晚 特意 开 周六 的 闹钟	可是 我 忘记 了 知道 今天 上班 早上 醒 了 之后 一看 时间 恍然大悟 哎越 急 越 堵车
可是 我 忘记 了 知道 今天 上班 早上 醒 了 之后 一看 时间 恍然大悟 哎越 急 越 堵车	快去 看看 栋哥 堵车 急 也 没用 淡定
快去 看看 栋哥 堵车 急 也 没用 淡定	哈哈 真 希望 见到 真人 啊
所以 减 还是 不减	当然 得 减 了 三月 不 减肥 四月 徒 伤悲
当然 得 减 了 三月 不 减肥 四月 徒 伤悲	我 才 三斤
我 才 三斤	加油 加油 一定 可以 的
加油 加油 一定 可以 的	加油
古龙 剧拍 的 太少 啦 我 倒 挺 期望 他 拍 我 最 爱 的 大旗 英雄传 可惜 基本 没 可能 本身 书 就 够 冷 再 加上 各种 不 可控 的 外 在 因素	当初 古龙 在世 的 时候 古龙 剧拍 得 比 金庸 多多 了 古龙 去世 之后 金庸 剧才 被 拍 得 多 了 起来 毕竟 现在 金庸 还 健在 不过 现在 武侠剧 整体 式微 网络小说 改编 占 了 主导
当初 古龙 在世 的 时候 古龙 剧拍 得 比 金庸 多多 了 古龙 去世 之后 金庸 剧才 被 拍 得 多 了 起来 毕竟 现在 金庸 还 健在 不过 现在 武侠剧 整体 式微 网络小说 改编 占 了 主导	一晃 就是 这么 多年 过去 了 属于 后 的 记忆 后 的 童年 就此 一去不返 这种 成人 童话 再难 流行 被 其他 的 新鲜 事物 取而代之 也 是 大势所趋 转眼 便是 后 的 天下 了 这 就是 史进
图一 为啥 没有 高清	栋哥 微博上 的
栋哥 微博上 的	这 也 不 高清 我 翻到 过 没存
两张 两张 两张	是 每人 一张
是 每人 一张	有 一张 也好 啊
这 是 咋 了	一时 难以 自制 一时冲动 一言难尽
一时 难以 自制 一时冲动 一言难尽	发生 啥事 了 我 这 完全 状况 外
发生 啥事 了 我 这 完全 状况 外	没有 我 只是 有感而发
没有 我 只是 有感而发	知道 是 啥事 了 前些 日子 就 看到 了 原来 是 真的 我 还 说 欢瑞 现在 主捧 的 小生 小花 真签 了 确实 一言难尽
知道 是 啥事 了 前些 日子 就 看到 了 原来 是 真的 我 还 说 欢瑞 现在 主捧 的 小生 小花 真签 了 确实 一言难尽	在 官方 出来 之前 我会 当 这 是 传言
在 官方 出来 之前 我会 当 这 是 传言	如果 是 真的 这事 吧 有利有弊 不管怎样 相信 他 支持 他 吧 我 也 不 知道 该 说 啥
如果 是 真的 这事 吧 有利有弊 不管怎样 相信 他 支持 他 吧 我 也 不 知道 该 说 啥	就是 支持 他 这 一点 是 不会 变 我们 并 不能 左右 他 什么 他 好 就 好 了
是不是 不 喜欢 这家 公司 的 宣传 手法	可能 是因为 不 喜欢 某应 才 把 想 的 很 吧
可能 是因为 不 喜欢 某应 才 把 想 的 很 吧	原来 阿诺 工作室 是 欢瑞 的 啊
唉 支持 他 的 决定 吧	支持 他 是 我 对 他 的 态度 接 不 接受 是 我 个人 的 问题
支持 他 是 我 对 他 的 态度 接 不 接受 是 我 个人 的 问题	是 这样 的
是 这样 的	尽力 吧
原来 穿 的 真 不是 秋衣	我 就 说 嘛 一 开始 说 是 一件 后来 想到 他 的 风格 又 否定 了
我 就 说 嘛 一 开始 说 是 一件 后来 想到 他 的 风格 又 否定 了	以后 要用 型 男 的 眼光 看待 他
以后 要用 型 男 的 眼光 看待 他	他 只是 一枚 低调 的 小 哥哥
蛮 拼 的	有个 拼 的 爱豆 迷妹 就 会 有样学样 啊
有个 拼 的 爱豆 迷妹 就 会 有样学样 啊	为 喜欢 的 爱豆 拼 义不容辞 心甘情愿
栋哥 为什么 不 跟 粉丝 互动 互动 呀	因为 忙 睡觉时间 都 不够
因为 忙 睡觉时间 都 不够	喔 我 也 只是 问问 没有 抱怨 喔 不要 误会 就算 栋哥 没有 出来 互动 我 也 是 喜欢 的 就 喜欢 这 一个 男艺人
喔 我 也 只是 问问 没有 抱怨 喔 不要 误会 就算 栋哥 没有 出来 互动 我 也 是 喜欢 的 就 喜欢 这 一个 男艺人	嗯 嗯 也 是 希望 大家 能够 理解 偶像 昨天 语气 不太好 抱歉 哦
他 要是 回 你 我 就 把 手机 吞 了	我 估计 会回 的 然后 坐等 你 直播 吞 手机 一定 要是 肾机 啊 当然 这 前提 下 是 他 能 看到
我 估计 会回 的 然后 坐等 你 直播 吞 手机 一定 要是 肾机 啊 当然 这 前提 下 是 他 能 看到	哈哈哈 感觉 自己 给 自己 挖 了 个 坑 不详 的 预感
他 在线 也 是 不会 给 我们 回 信息 的	你 怎么 知道 他 不会 回 我 收到 过 他 的 回复 这 对 你 来说 是不是 比较 打脸
你 怎么 知道 他 不会 回 我 收到 过 他 的 回复 这 对 你 来说 是不是 比较 打脸	能 截图 让 大家 看看 呗
能 截图 让 大家 看看 呗	截图 打脸 吗 如果 我 截图 你 会 道歉 吗
送 他	万一 被 他 鄙视 怎么 破
万一 被 他 鄙视 怎么 破	他 可以 送给 剧组 的 喝 啊 穿着 太子 装
他 可以 送给 剧组 的 喝 啊 穿着 太子 装	噗 噗 噗 噗 噗 好 吧 给 栋栋 当 人情
噗 噗 噗 噗 噗 好 吧 给 栋栋 当 人情	等 下 给你个 惊喜
等 下 给你个 惊喜	坐守 惊喜
帅气	年 的 军校 生活 让 他们 成熟 了 许多
年 的 军校 生活 让 他们 成熟 了 许多	磨练 出来 了
单身 一辈子	这个 不行
这个 不行	介绍 一个
介绍 一个	喜欢 啥样 的
喜欢 啥样 的	女 的
还是 这话 爱 听 这 就 好比 我 和 你 说 天气 真好 你 告诉 我 今儿个 吃 的 好 饱	不 在 一个 频道
不 在 一个 频道	而 他 那个 我 又 不想 看 我 那个 频道 他 又 不想 来 哎 抱歉 只好 说 拜拜
而 他 那个 我 又 不想 看 我 那个 频道 他 又 不想 来 哎 抱歉 只好 说 拜拜	重新 重新 开始 很累
重新 重新 开始 很累	何不 一人 我 饮酒 醉
对 啊 对 啊	喜欢 吧
喜欢 吧	喜欢
怎么 那么 熟悉 呢	熟悉 么
熟悉 么	说 得 很 好
心累 每天 不是 过 是 熬	你 还 年轻 哦
你 还 年轻 哦	不必 伤感
不必 伤感	入 了 军营 就 变 了 吗
还好 吧 上班 就 累 不 上班 就 不累	休息 了 玩 的 也 累
休息 了 玩 的 也 累	我 宁愿 玩 的 累
你 的 手机 真 好	你 这 是 不 知道 怎么 回 了 吧
你 这 是 不 知道 怎么 回 了 吧	这 手机 怎么 了
值得 骄傲	刺激 么
刺激 么	很 刺激 但是 感觉 很 有 挑战性 男人 应该 一生 尝试 一次
很 刺激 但是 感觉 很 有 挑战性 男人 应该 一生 尝试 一次	挑战 自我 超越 极限
挑战 自我 超越 极限	有 机会 也 要 去 试试 这样 的 经历
呃 人家 估计 只是 个 小女孩 耍耍 性子 发 发牢骚 一个 并 不怎么 成熟 的 想法 而已 讲清楚 道理 就行了 或者 经过 时间 的 沉淀 她 也 会 明白 滴 都 消消气	不是 的 那 不是 个 小姑娘
不是 的 那 不是 个 小姑娘	啊 我 感觉 这 类 幼稚 的 行为 不是 小姑娘 不 符合 她 的 人设 我 果然 生活 在 四次 员元 完全 没 搞清楚 状况
看看 我家 爱豆	别误会 啊 相信 如果 你 爱豆 赶着 拍戏 也 不太会 有 时间 上 微博 的 况且 回复 粉丝 而且 你家 爱豆 比较 率真 我爱豆 最近 拍戏 很 赶 还 总 有人 诋毁 说 从不 回复 粉丝 不能 忍
别误会 啊 相信 如果 你 爱豆 赶着 拍戏 也 不太会 有 时间 上 微博 的 况且 回复 粉丝 而且 你家 爱豆 比较 率真 我爱豆 最近 拍戏 很 赶 还 总 有人 诋毁 说 从不 回复 粉丝 不能 忍	嗯 嗯 理解 有些 不讲道理 的 粉丝 的确 很烦 的
话 是 对 的 只是 没有 必要 为 一个 人 的 行为 大费周章 韩栋栋 看 了 也 是 难受 的	说 出来 让 不 理解 的 人 理解 理解 我 在 他 那 透明 应该 不会 看到
说 出来 让 不 理解 的 人 理解 理解 我 在 他 那 透明 应该 不会 看到	我怕 他 心血来潮 又 进超话 看
对 啊 你 以为 你 是 谁 留言 就要 回复 吗	对 啊 什么 逻辑
对 啊 什么 逻辑	大概 是
几乎 没 明星 会 回复 的 哪儿 回 的 过来 啊 哈哈	对 啊 我 也 是 黑人 问号 脸
对 啊 我 也 是 黑人 问号 脸	我 觉得 他 已经 很 好 了 真的 我 看 偶尔 他 也 在 自己 微博下 回复 经纪 公司 什么 的 都 不 允许 明星 和 粉丝 过于 亲近 要 树立 形象 的 但是 他 为 人 一看 就是 坦率 型 的 值得 被 尊重 和 喜爱
哇	用 起来
用 起来	啥 用 起来
啥 用 起来	素材 啊
素材 啊	我 发现 大 宝剑 和 王真人 被 用 得 好多
我 发现 大 宝剑 和 王真人 被 用 得 好多	因为 好用 啊 还有 清装里 的 多尔衮 民国 里 的 白二 只是 很少 有 民国 的 群像
因为 好用 啊 还有 清装里 的 多尔衮 民国 里 的 白二 只是 很少 有 民国 的 群像	那 也 是 等 我 做 个 群像 但是
那 也 是 等 我 做 个 群像 但是	木事 我 就是 为 大家 提供 个 素材 思路
木事 我 就是 为 大家 提供 个 素材 思路	会 做 的 我 大概 会坑 的 只有 吻 了
哇	加油 迷妹
加油 迷妹	护法 我 觉得 自己 毁 了 一个 脑洞
护法 我 觉得 自己 毁 了 一个 脑洞	填好 就 不算 毁
你 做 过 什么	就是 迷妹 追星 不 觉得 脸皮厚
就是 迷妹 追星 不 觉得 脸皮厚	我 脸皮薄
我 脸皮薄	迷妹 追星 不 觉得 脸皮厚
迷妹 追星 不 觉得 脸皮厚	没 毛病 啊
没 毛病 啊	我 懂
由晖晖晖晖子 由 由 你 都 不 来看 公主 殿下	我们 福 这张 居然 有点 好看
我们 福 这张 居然 有点 好看	福 今天 有 好多 新闻 图 人气
别闹 他 只是 把 自己 弄脏了	真的 是 棕色 的 不信 你 百度 搜索 一下 就 知道 了
真的 是 棕色 的 不信 你 百度 搜索 一下 就 知道 了	真的 有 啊
去 不了 想要 海报 怎么 破魔 游纪	官博送 你
官博送 你	真的 吗
真的 吗	你 要 哪个
你 要 哪个	果断 的 第一 小 男主小 和尚 崔 小弟 哒
果断 的 第一 小 男主小 和尚 崔 小弟 哒	好 哒
好 哒	看 私信 看 私信 么 么 哒
每天 都 早起 签到 的 我	每天 都 晚睡 签到 的 我
每天 都 晚睡 签到 的 我	哈哈哈哈 你 赢 了
太 开心 啦	不 容易
不 容易	对 呀 对 呀
早就 申请 啦	那 这 是 为啥 嘞 在 申请 墨爷 前一天 我 一起 申请 的 卡斯 罗 当天 就 下来 了 好像
那 这 是 为啥 嘞 在 申请 墨爷 前一天 我 一起 申请 的 卡斯 罗 当天 就 下来 了 好像	我 也 纳闷 也 没 给 个 回复
志玲 申请 一下 主持人 试试	试 了
试 了	棒棒 哒
都 满足条件 了 还 不行 吗	不 知道 哪个 环节 有 问题
不 知道 哪个 环节 有 问题	微博 总是 出 幺 蛾子
木有	人数 还 没有 齐 吗
人数 还 没有 齐 吗	人数 早就 超过 很多 呢
人数 早就 超过 很多 呢	渣浪 真是 的
这算 开通 了 吗 签到 的 地方 呢	我 是 看 老多 有 一个 金牌 铲 屎 官 的 话题 点 进去 也 是 没有 签到 的 地方 然后 看 了 看 墨爷 话题 也 还是 没有 然后 别的 都 有 咋 回事儿 捏
我 是 看 老多 有 一个 金牌 铲 屎 官 的 话题 点 进去 也 是 没有 签到 的 地方 然后 看 了 看 墨爷 话题 也 还是 没有 然后 别的 都 有 咋 回事儿 捏	我 再 研究 下
怎么 还 没 成功 呢 上次 弄 了 一个 别的 超级 话题 特别 快 呀	估计 人 越多越 快 吧 搞不懂 哎
估计 人 越多越 快 吧 搞不懂 哎	再 等等
好像 够 了 哦	是 哒
是 哒	兴奋
我 的 右脚 一崴 再 崴 脚踝 快 废 了 视频 的 动作 做不了 了 都 怪 没 好好 保护	我 也 是 韧带 拉伤 该 怎么办
我 也 是 韧带 拉伤 该 怎么办	我 是 第一次 崴 到 当时 有 排练 时间 紧 第二天 又 接着 练 踮脚 都 疼 出汗 后来 好 了 然后 第二次 崴 到 第二天 表演 第三次 崴 到 当时 以为 断 了 吓 得 我 原地 坐下 就 哭 现在 脚踝 肿着 快 一个月 了 一动 就 疼 哎
王牌 对 王牌 那招 太 有意思 了	你 的 头像 是 四叔 于 朦胧 吧
你 的 头像 是 四叔 于 朦胧 吧	还有 要 叫 四哥
还有 要 叫 四哥	好 吧 四哥 哈哈哈 没有 其实 我 也 蛮 喜欢 四哥 的
好 吧 四哥 哈哈哈 没有 其实 我 也 蛮 喜欢 四哥 的	嗯 嗯 一起 爱 反正 博爱 无罪 嗯 所以 我 才 想 把 四哥 抱 回家 最 主要 的 原因 是因为 又廷哥 有 圆圆 姐 了 我们 抢 不 走 只能 退而求其次 了
嗯 嗯 一起 爱 反正 博爱 无罪 嗯 所以 我 才 想 把 四哥 抱 回家 最 主要 的 原因 是因为 又廷哥 有 圆圆 姐 了 我们 抢 不 走 只能 退而求其次 了	呵呵 你 这个 说 的 有理 哈哈
呵呵 你 这个 说 的 有理 哈哈	本来 就是 啊 谁 让 我 现在 是 敏感期 呢 你 看 我 关注 你 就 知道 我 为什么 这么 说 了 苦笑
本来 就是 啊 谁 让 我 现在 是 敏感期 呢 你 看 我 关注 你 就 知道 我 为什么 这么 说 了 苦笑	哎 是 的 呢
哎 是 的 呢	嗯 嗯 哎 不 说 了 满满的 苦 啊 玩儿 游戏 去 了
嗯 嗯 哎 不 说 了 满满的 苦 啊 玩儿 游戏 去 了	好 的
对 啊 你 讨厌 啊 长得个 鸡 吧 样	长 你 个 鸡巴 样
长 你 个 鸡巴 样	边伯贤 是 你 命 啊 鸡 吧 你 妈 知道 么
噢 你 先 让 你 的 小 姐妹 不要 先 撩 啊	说 了 你们 不 转发 了 我 就 删
说 了 你们 不 转发 了 我 就 删	哈哈哈哈 你 看 我 现在 转发 了 么 没有 噢 这 是 评论 啊 搞 得 清 嘛 智障
滚 粗 还 艾特 我哥 你 算 什么	因为 饭 随爱豆 啊
因为 饭 随爱豆 啊	哦 哦 是 么 那 你 这种 算 随 了 谁 让 我 思考 思考 啊
宋仲基	什么 鬼 宋仲基 是 首歌 的 名字
什么 鬼 宋仲基 是 首歌 的 名字	宋慧乔 的 男人 只能 想到 宋仲基
给 它 照 了 个 相	没事 吧
没事 吧	没事 全在
你 去 草莓 嘛	还 不让 我 转发 了
还 不让 我 转发 了	辣鸡 万一 见鬼 中 了 呢
辣鸡 万一 见鬼 中 了 呢	给 你 啊
给 你 啊	真 爱
真 爱	骗 你 的
骗 你 的	反正 你 去 不了 草莓
反正 你 去 不了 草莓	略略 略
略略 略	你 不是 真爱 我 才 是 华晨 宇 的 真爱
你 不是 真爱 我 才 是 华晨 宇 的 真爱	人家 又 不 认识 你 哪位 啊 拜托
人家 又 不 认识 你 哪位 啊 拜托	我 跟 老公 对视 过 你 有 嘛
我 跟 老公 对视 过 你 有 嘛	然而 有 什么 用 呢 我 还 站 过 他 身边 一米 以内 呢
啊 好 主意 那 我 有 吗	有交 大包 和 小王子 包
有交 大包 和 小王子 包	好 啊 好 啊
是 徐哥 指导 有方 啊 回 南昌 了 吗	回 了
回 了	好 的 得空 了 请 徐哥 吃饭
好 的 得空 了 请 徐哥 吃饭	得空 过来 玩
得空 过来 玩	嗯 你 那 爱 疯 土豪 金 怎么 显示 呀
嗯 你 那 爱 疯 土豪 金 怎么 显示 呀	来 了 教 你
来 了 教 你	哈哈 徐哥会 冲洗 胶卷 么
哈哈 徐哥会 冲洗 胶卷 么	会 呀
会 呀	好 的 我 要 向 你 请教 下 怎么弄 我 一直 想 搞 个 暗房 先 从 黑白 的 开始
有时候 到 了 一定 阶段 就是 容易 在 人生 的 十字路口 徘徊 但 有种 目标 和 自信 会 让 你 坚持 你 自己 的 那段 路 跟着 自己 的 感觉 继续 前行	嗯 呵呵 希望 红 也 越来越 好 啦
嗯 呵呵 希望 红 也 越来越 好 啦	嗯 嗯 会 的
这是 杂志 吗 问 一下 是 哪本	爱格 杂志 年
爱格 杂志 年	好 哒 谢谢
李熹 子 啊 他 演 的 某个 角色 太棒了	他演 的 每个 角色 都 太棒了 不管 是 现在 还是 将来 我 相信 他 都 会 努力 演好 的
他演 的 每个 角色 都 太棒了 不管 是 现在 还是 将来 我 相信 他 都 会 努力 演好 的	嗯 嗯
没 在 超话	我 是 在 熊梓淇里 发 的 渣 浪 又 不让 我发 超话 啊
我 是 在 熊梓淇里 发 的 渣 浪 又 不让 我发 超话 啊	它 没带 超话 的 条 啊
它 没带 超话 的 条 啊	渣浪 有毒
无爱 你 也 去 了	我 没 去
我 没 去	我姐 去 了 我 让 我姐 去 接 了 李熹 子
我姐 去 了 我 让 我姐 去 接 了 李熹 子	哇 你 姐 被 熹子 迷倒 没
哇 你 姐 被 熹子 迷倒 没	迷死 了 昨晚 上 还 可 高 冷 了 今天 手抖 的 图 都 没 拍 几张
迷死 了 昨晚 上 还 可 高 冷 了 今天 手抖 的 图 都 没 拍 几张	今天 表哥 走 的 好 急 啊 有 工作 去 接机 的 表妹 也 没 拍 很多 图
今天 表哥 走 的 好 急 啊 有 工作 去 接机 的 表妹 也 没 拍 很多 图	我 知道 大家 都 没 拍 到 多少
还 没 打开 看 呢 先 问候 一下 小 公主 吧 早安 吉祥	荣哥 早上好
荣哥 早上好	累 了 吧 小妹
农民 是 很 辛苦 ! 现代化 农业 离 中国 还 远 了 点	离 城市 近 的 农村 俏 好些
离 城市 近 的 农村 俏 好些	北京 上海 郊区 农民 比较 富 ! 云南 贵州 等 农村 苦 !
你们 那 月初 就 能 望月 吗	探月
探月	你 的 顶呱呱 还 能 上 月球 上 探月
你 的 顶呱呱 还 能 上 月球 上 探月	梦想 哦
梦想 哦	梦想 总有 实现 的 那天
洺 洺 早安 幸福美好 就 在 你 身边 开心 早餐	谢谢您
谢谢您	您 总是 辣 么 客气 谢谢您
您 总是 辣 么 客气 谢谢您	友 洺 假期 愉快 美女 开心
来看 你 啦 宝宝	也 烦 也 不烦
也 烦 也 不烦	看来 心里 还 挺 矛盾 的
只有 哥才 是 你 的 超级 粉丝	幸运
幸运	是 说 我 还是 说 你 呢
节日快乐	快乐 快乐
快乐 快乐	看起来 心情 不错 啊
看起来 心情 不错 啊	死 了 也 不 遗憾 了
死 了 也 不 遗憾 了	不会 吧
不会 吧	我 说 的 是 上网 开心
我 说 的 是 上网 开心	太 吓人 啦
单纯	老师 评论 很 到位
老师 评论 很 到位	你 单纯 得 可爱 就象 图中 的 小花
你 单纯 得 可爱 就象 图中 的 小花	下午 好 吉祥如意
下午 好 吉祥如意	老师 好
莫名其妙 的 就 陷 进去 了	我 看 的 全程 痴汉笑 赵又廷 笑 的 很 夜华 真的
我 看 的 全程 痴汉笑 赵又廷 笑 的 很 夜华 真的	看着 他 笑 自己 就 跟着 傻笑
朋友 何必 这样 折磨 自己	一个 忧伤 的 故事
一个 忧伤 的 故事	表示 刚 睡醒
表示 刚 睡醒	这 作息 颠倒
求 黄鳝 女 视频 谢谢	没 啥 可 看 的
没 啥 可 看 的	这 不 就是 好奇 么 没见识 过
看 了 你 的 微博 我 不 认识 尔字 了	我 的 才 是 正确 的 别 被 他们 带坏
我 的 才 是 正确 的 别 被 他们 带坏	不是 因为 你 艾特 了 好多 海尔 一下 看到 太 多 海尔 就 觉得 不 认识 那个 字 了 而且 那个 像尔字 的 字 我 是 本来 就 不 认识
因为 海尔 冷 所以 我 给 他 加 了 一把 火	你 是 我 心中 的 一把 火
你 是 我 心中 的 一把 火	点亮 你 生命 的 火
我 也 是 这样 请问 是 怎么 了	我 也 搞不懂 很 烦躁
我 也 搞不懂 很 烦躁	你 去 医院 看过 吗
你 去 医院 看过 吗	看 了 说 灰指甲 在 吃药 感觉 没什么 用
我 脚指甲 也 是 查 了 好多 但是 啥 问题 都 没有 医生 说 就 这样 吧 等 它 自己 恢复 我 的 现在 差不多 好 了 就 两边 大 脚趾 还有 一点点	我 就 怕 是 灰指甲 不 及时 治疗 传染 别人 不然 不会 这么 紧张
我 就 怕 是 灰指甲 不 及时 治疗 传染 别人 不然 不会 这么 紧张	不是 灰指甲
不是 灰指甲	你 有 几个 指甲 会 这样 空 的 啊 我 从 去年 一个 到 这个 月 有 个 了
你 有 几个 指甲 会 这样 空 的 啊 我 从 去年 一个 到 这个 月 有 个 了	我 就是 脚 两边 大拇指 现在 也 有点 我 就 把 那 部分 剪 了
我 就是 脚 两边 大拇指 现在 也 有点 我 就 把 那 部分 剪 了	好烦 我 把 空 的 剪 了 长 出来 是 好 的 可是 过 不了 多久 又 空 了 问下 你们 家 是不是 就 你 一个 人 这样 其他人 都 不会
好烦 我 把 空 的 剪 了 长 出来 是 好 的 可是 过 不了 多久 又 空 了 问下 你们 家 是不是 就 你 一个 人 这样 其他人 都 不会	好像 就 我 感觉 可能 是 缺 某种 元素 把 多 吃水果 和 蔬菜
好像 就 我 感觉 可能 是 缺 某种 元素 把 多 吃水果 和 蔬菜	我前 几天 开始 补充 金维他 和 钙片 了 有 效果 再 来 告诉 你们 啊
我 都 五年 了	真的 不是 灰指甲 吗 我 去 医院 医生 看 一眼 就 说 灰指甲 我 都 吃 了 一个多月 药 了 按 灰指甲 的 方法 治疗 的 然而 服药 期间 还 增加 一个 发空 的 指甲 我 也 是 很 无奈 啊
真的 不是 灰指甲 吗 我 去 医院 医生 看 一眼 就 说 灰指甲 我 都 吃 了 一个多月 药 了 按 灰指甲 的 方法 治疗 的 然而 服药 期间 还 增加 一个 发空 的 指甲 我 也 是 很 无奈 啊	不是 灰指甲 应该 是 指甲油 的 伤害 我 是 涂 了 指甲油 后 开始 这样 的 一直 都 这样 去 医院 大夫 也 看不出来 但 绝对 不是 灰指甲
不是 灰指甲 应该 是 指甲油 的 伤害 我 是 涂 了 指甲油 后 开始 这样 的 一直 都 这样 去 医院 大夫 也 看不出来 但 绝对 不是 灰指甲	真是 没辙 了 大家 互相帮助 啊 要是 有 好 法子 整好 了 要 造福 人民 群众 哦
我 也 有 这种 情况 手指 只有 大拇指 有 月牙	民间 说 月牙 多 身体 好 我 确实 身体 很差
民间 说 月牙 多 身体 好 我 确实 身体 很差	我 指甲 也 一直 往 后退
我 也 是 感觉 是 指甲 软和 薄少 做 指甲	可是 我 脚指甲 没有 做 诶 不 懂 为什么
可是 我 脚指甲 没有 做 诶 不 懂 为什么	哦 那 需要 去 检查一下
我 也 是 去 医院 验血 也 没 查出来 都 五六年 了	请问 验血 是验 什么 血常规
请问 验血 是验 什么 血常规	可 我 这 五六年 都 不 美甲 了 指甲 还是 这样 脚 也 跟着 这样 我 比 你 的 严重 大夫 都 看不出来 怎么回事 我 也 愁
可 我 这 五六年 都 不 美甲 了 指甲 还是 这样 脚 也 跟着 这样 我 比 你 的 严重 大夫 都 看不出来 怎么回事 我 也 愁	我 手指甲 现在 长好 了 我 不 知道 是不是 因为 吃 了 药 还是 本来 就 会 好 医生 说 我 是 灰指甲 开 的 口服药 我 都 吃 了 月 了 万一 不是 我 就是 白痴 了 伤害 身体
我 手指甲 现在 长好 了 我 不 知道 是不是 因为 吃 了 药 还是 本来 就 会 好 医生 说 我 是 灰指甲 开 的 口服药 我 都 吃 了 月 了 万一 不是 我 就是 白痴 了 伤害 身体	啥 药快 告诉 我 我 也 吃 我 比 你 严重 多多 了
啥 药快 告诉 我 我 也 吃 我 比 你 严重 多多 了	可 不敢 乱 吃药 啊 这药 很 伤 身体 的 我 都 烦死 了 就 怕 是 误会 一场 氟康 分散片 这药 是 处方药 不要 乱 吃 我 脚指甲 没见 好 依然 发白 估计 后期 还是 会空
沃德妈 我 感觉 我 跟 你 仿佛 不 在 一个 城市 我 今天 穿 好 厚	好不容易 一点 夏天 的 样子 人家 女生 穿 了 裙子 我 这 今天 还 出汗 了
好不容易 一点 夏天 的 样子 人家 女生 穿 了 裙子 我 这 今天 还 出汗 了	是 的 我们 学校 女生 今天 也 是 穿 好 少 我 仿佛 还 在 冬季
是 的 我们 学校 女生 今天 也 是 穿 好 少 我 仿佛 还 在 冬季	大约 在 冬季
再 玩球 我 就 剁 手	我 决定 惩罚 自己 这个 月 不 玩球 了
我 决定 惩罚 自己 这个 月 不 玩球 了	再 玩 就是 狗 气死我了
再 玩 就是 狗 气死我了	我 当时 真的 不该 觉得 坐太偏 现在 连坐 都 没有 了
我 当时 真的 不该 觉得 坐太偏 现在 连坐 都 没有 了	我 还 嫌人家 第一排 呢 我 是 宇宙 无敌 大 傻
我 还 嫌人家 第一排 呢 我 是 宇宙 无敌 大 傻	我 这回 真 懂 了 坐 那 不要 选 主要 是 有 座 啊
我 这回 真 懂 了 坐 那 不要 选 主要 是 有 座 啊	嫂子 都 要 卸载 了
怎么 了	很 励志
很 励志	智障
诶 诶 突然 发现 这 好像 不是 简叔 的 脸 是 头发	真相 居然 是 这样
真相 居然 是 这样	当 我们 都 傻傻的 以为 那 是 简叔 的 脸 其实 那 是 头发
当 我们 都 傻傻的 以为 那 是 简叔 的 脸 其实 那 是 头发	是 的 啊
是 的 啊	全是 套路
简叔 是从 非洲 旅行 回来 了 嘛	是 啊
是 啊	对 啊
对 啊	所以 简叔 的 头发 是 随树姐 么 好长 好长
所以 简叔 的 头发 是 随树姐 么 好长 好长	及 腰
及 腰	腻害
这样 真的 好 吗	哈哈哈哈 哪里 不好 啦
哈哈哈哈 哪里 不好 啦	让 我 想起 了 我家 冬天 的 炭
让 我 想起 了 我家 冬天 的 炭	简为 我们 带来 温暖 高尚 的 小 煤球
简为 我们 带来 温暖 高尚 的 小 煤球	被 这样 一 描述 感动 得 不得了 了
绝望	哈哈哈 哈哈哈 哈哈哈 就是 正面 啊 没错
哈哈哈 哈哈哈 哈哈哈 就是 正面 啊 没错	简叔 今天 不潮 了
简叔 今天 不潮 了	穿 睡衣 哈哈哈 哈哈哈
穿 睡衣 哈哈哈 哈哈哈	笑 死 我 了
哈哈哈 今天 群里 还 会 直播	直播 直播
直播 直播	嗯 嗯 在 群里
嗯 嗯 在 群里	几点
几点	刚刚 挂 都 没人 一起 聊好 尴尬
刚刚 挂 都 没人 一起 聊好 尴尬	噗 完美 错过
大佬 的 碰面	嘿嘿 开心
嘿嘿 开心	居然 觉得 简叔 很潮 我 眼睛 出 问题 了 吗 哈哈哈哈 当然 我 美少女 哥哥 的 颜 我 是 服气 的
悄悄 看	要 看 时间 是
要 看 时间 是	不 确定 看 心情 和 电量
不 确定 看 心情 和 电量	唔 祈祷 你 心情 棒棒 哒 加 电量 满满的
是 起夜 发 的 吗	是 还 没 睡
是 还 没 睡	现在 都 已经 醒 了
现在 都 已经 醒 了	等 下 我 发微博
这个 对 ? 那个 对 ? 怀疑 人生	人生 第一次 不 知道 该站 谁
人生 第一次 不 知道 该站 谁	一起 哭 心乱如麻
一起 哭 心乱如麻	你 看 新鲜 迪 了 吗 那个 保 你 瞬间 开心
你 看 新鲜 迪 了 吗 那个 保 你 瞬间 开心	亲爱 的 睡 了 么 我 有点 困了 晚安 哦 给 你 笔 笔芯
亲爱 的 睡 了 么 我 有点 困了 晚安 哦 给 你 笔 笔芯	嗯 嗯 要 睡 了 晚安 好 梦
我 之前 混 了 快 年 的 饭 圈 然而 都 赶不上 迪圈 一小半 心累	别 随便 跟风 有些 事情 看看 就 好
别 随便 跟风 有些 事情 看看 就 好	所以 还是 并 不 站 哪 一方
所以 还是 并 不 站 哪 一方	我会 判断 一下 饭圈 有些 事情 有些 人 早就 看在眼里 好多 事情 只不过 没 说破
什么 事 啊	饭圈 撕 逼
饭圈 撕 逼	没事 不 开心 的 时候 看看 迪 大爷 什么 都 好 了 他 还是 纯粹 调皮 的 他 就 好 了
没事 不 开心 的 时候 看看 迪 大爷 什么 都 好 了 他 还是 纯粹 调皮 的 他 就 好 了	这次 又 撕得 挺大 的 嗯 呢 我 也 想 找回 最初 那种 纯粹 的 心态
拿 旧照 干什么	没拍
没拍	这 就 对 了 不能 和 别人 拍
咋 了 你 又	我 看书 看到 绝望
我 看书 看到 绝望	心痛
心痛	唉 我 也 是
唉 我 也 是	我 觉得 我 不 太 适合 和 哲学 打交道 一切 和 哲学 相关 的 学科 都 是 我 的 痛
我 觉得 我 不 太 适合 和 哲学 打交道 一切 和 哲学 相关 的 学科 都 是 我 的 痛	咋 学开 哲学 了
咋 学开 哲学 了	都 是 心酸 泪 我 自考 剩 了 四科 两科 都 和 哲学 挂钩 我 很 无奈 我 大学 最不爱学 的 语言学 都 可以 学得 溜溜 的 但是 哲学 这破 玩意儿 真是 没辙
还 不 睡	你 还 不 睡
你 还 不 睡	还 没 睡意
还 没 睡意	哈哈 一样
难道 有 你 帅	比 我帅
比 我帅	乱讲
双胞胎	不是 啦 视频 弄 的
不是 啦 视频 弄 的	就 说 怎么 这么 像
看到 了	高中 的 时候 文学 细菌 最 多 后来 慢慢 就 没 了
高中 的 时候 文学 细菌 最 多 后来 慢慢 就 没 了	银河 文学 弑情 你 写 的 小说
您 给 我 一种 我 高中语文 老师 的 感觉	今后 你 就 将 我 当 你 老师 吧
今后 你 就 将 我 当 你 老师 吧	语文 老师 么 我 很 乐意 呢
语文 老师 么 我 很 乐意 呢	太 开心 了 这辈子 终于 有个 学生 了 得 喝 两杯 庆祝 一下
太 开心 了 这辈子 终于 有个 学生 了 得 喝 两杯 庆祝 一下	这 就 很 厉害 了 要 看看 我 高中 老师 写 的 东西 吗
这 就 很 厉害 了 要 看看 我 高中 老师 写 的 东西 吗	当然 有 吗 我 要 拜读
当然 有 吗 我 要 拜读	你 设置 了 不 支持 图片 评论 那 我 就 发个 微博 你 看看 吧 是 老师 写 的 短篇
你 设置 了 不 支持 图片 评论 那 我 就 发个 微博 你 看看 吧 是 老师 写 的 短篇	没有 吧 我 虽然 开通 快 两年 了 但是 真正 玩微 博才 一个月 很多 功能 我 都 不 懂
没有 吧 我 虽然 开通 快 两年 了 但是 真正 玩微 博才 一个月 很多 功能 我 都 不 懂	我 基本 不玩 微博
我 基本 不玩 微博	今后 为了 老师 常 来看 看好 吗
今后 为了 老师 常 来看 看好 吗	最近 为了 认证 一直 在 到处 求 粉丝
最近 为了 认证 一直 在 到处 求 粉丝	他 有 微博 吗
你 是不是 特别 讨厌 你 的 那位 老师	不 不 我 很 喜欢 他 他 也 喜欢 写诗 写 了 还 经常 在 我们 班级 里 炫耀
不 不 我 很 喜欢 他 他 也 喜欢 写诗 写 了 还 经常 在 我们 班级 里 炫耀	你 那 老师 是因为 太 寂寞 了 奢望 在 你们 班上 找到 知音 奈何 奈何
你 那 老师 是因为 太 寂寞 了 奢望 在 你们 班上 找到 知音 奈何 奈何	我们 会 夸夸 他 的
把 儿子 还给 我	那 是 我 儿子
那 是 我 儿子	也 是 我 儿子
也 是 我 儿子	不是 你 儿子 跟 你 没有 任何 关系
不是 你 儿子 跟 你 没有 任何 关系	明明 是 我 儿子
明明 是 我 儿子	已经 不是 你 儿子 了
已经 不是 你 儿子 了	可惜 我 不 爱 你 了
哎 呦 卧槽 盗用 名言 名句	这 不是 觉得 你 说 的 贼 有 道理
这 不是 觉得 你 说 的 贼 有 道理	没 毛病
至少 我 就 可以 咯	哪里 来 的 自信 啊
哪里 来 的 自信 啊	你 给 的
你 给 的	我 还 能 说 什么 呢
我 还 能 说 什么 呢	那 就 别 说话 赞 我 就 好
那 就 别 说话 赞 我 就 好	给 你 点 两个 赞
给 你 点 两个 赞	那 你好 胖 哦
那 你好 胖 哦	我 可 瘦 了
我 可 瘦 了	瘦到 只 剩肉
瘦到 只 剩肉	我 竟 无言以对
我 竟 无言以对	那 就 乖乖 的 陪 我 等 薛之谦 的 第二首 新 歌 还有 五分钟
那 就 乖乖 的 陪 我 等 薛之谦 的 第二首 新 歌 还有 五分钟	才 不要 我 睡觉
才 不要 我 睡觉	听 都 听 完 了
好多	而已 我 打代练 不 知道 给 别人 打 了 多少 了
而已 我 打代练 不 知道 给 别人 打 了 多少 了	厉害
留 拥有 你 就 像 拥有 全世界	好 的 等 我 留言板 解封 了 去 给 你 留
好 的 等 我 留言板 解封 了 去 给 你 留	好滴 谢谢 亲
这个 表情 我 是 打 不 出来 的 哦	噗 你好 可爱
噗 你好 可爱	人家 明明 评论 了 两条
人家 明明 评论 了 两条	我 知道 呀 逗 你 呢 说 你 让 我 留 这个 表情
我 知道 呀 逗 你 呢 说 你 让 我 留 这个 表情	那 那个 你 就 不 出来 我 让 你 留 这个 表情
那 那个 你 就 不 出来 我 让 你 留 这个 表情	难为 我
难为 我	啊啊啊 啊啊啊
空城 旧梦 求带 飞 给 个 暖 心 留言 可以 喔	好 的 等 我 留言版 解封 了 就 去 给 你 留
好 的 等 我 留言版 解封 了 就 去 给 你 留	嗯 嗯 嘻嘻
那 啥 他 二叔	好 等 我 留言板 解封 了 就 去留
好 等 我 留言板 解封 了 就 去留	好 的
哪吒 啊 谢谢 小姐姐	等 我 留言板 解封 了 去 给 你 留
等 我 留言板 解封 了 去 给 你 留	那 你 记得 拿个 小 本子 记下来 这么 多万 一忘 了 呢 小姐姐
那 你 记得 拿个 小 本子 记下来 这么 多万 一忘 了 呢 小姐姐	这 上面 都 有 记录 呢
高冷	好 的 等 我 留言 解封 了 就 去 给 你 留
好 的 等 我 留言 解封 了 就 去 给 你 留	好 的
兄弟 有木有 什么 人 或者 什么 号 要 打 生存 的 我 想 打 呀 哈哈哈哈 帮 我 介绍 几个 呗	我 可以 让 你 打 生存 张
我 可以 让 你 打 生存 张	老哥 稳 啊 来 私聊
多少 生存 票子 我 帮 你 打 生存	我 还 需要 你 帮 我 打 生存
我 还 需要 你 帮 我 打 生存	嗯 行好 的 有人 需要的话 我 联系 你
嗯 行好 的 有人 需要的话 我 联系 你	谢谢 你 老哥
软窑求 留言	嗯 嗯 等 我 留言 榜 解封 了 就 去 给 你 留言
嗯 嗯 等 我 留言 榜 解封 了 就 去 给 你 留言	好 哒
兄弟 我	原来 是 铁院 兄弟
原来 是 铁院 兄弟	对 啊
小迷妹	你 带 我 呗
你 带 我 呗	我 还 希望 你 带走 超神 呢
我 还 希望 你 带走 超神 呢	好 几天 不 完 肯定 菜 的 跟 狗 一样
我 可以 吗 ! 亖 亖	璞 原谅 我 笑 了 还是 你 关注 动人 狙吧 我 知识 是 负 的
璞 原谅 我 笑 了 还是 你 关注 动人 狙吧 我 知识 是 负 的	那个 念 啦
没 问题 关注 我 吧 脾气好 就 别浪	敢找 人 了
敢找 人 了	咋啦 你 和 范不完 的 时候 我 就 不许 跟 别人 玩 啦
咋啦 你 和 范不完 的 时候 我 就 不许 跟 别人 玩 啦	你 和 他 玩吧
你 和 他 玩吧	不要 还是 你 会 玩 啦
亦 酷	你 不 傻
你 不 傻	你 不是 学 吉他 去 了 吗
你 不是 学 吉他 去 了 吗	偷 着 玩
厉害 了	比 你验 自己 厉害 点
比 你验 自己 厉害 点	哈哈
玩群 语音 杀 吗 可以 带 你 哟	我太菜 了
我太菜 了	没关系 的 群里 很多 大神 可以 带 你
没关系 的 群里 很多 大神 可以 带 你	哈哈 只要 不怕 我 坑
哇 谢谢 女神 姐姐 晒单	你 送 的 一小包 是 什么 看 图
你 送 的 一小包 是 什么 看 图	浏阳 炒米 浏阳 的 地方 特产 直接 吃香 香脆 脆 的
浏阳 炒米 浏阳 的 地方 特产 直接 吃香 香脆 脆 的	谢谢
弥猴桃 确实 不错 我 每 去 西安 都 要 买些 回来 祝你们 暢销 无阻	谢谢 谢谢 下次 回来 的话 我 送 你 一箱 猕猴桃 都行 自家 种植 的 没有 污染 健康
谢谢 谢谢 下次 回来 的话 我 送 你 一箱 猕猴桃 都行 自家 种植 的 没有 污染 健康	我 是 东北 辽宁 的 弥桃要 下果 时 可以 联系 一下 可以 帮 你 推销
我 是 东北 辽宁 的 弥桃要 下果 时 可以 联系 一下 可以 帮 你 推销	好 的 没有 任何 问题
陕西人	是 陕西 的 宝鸡 眉县
是 陕西 的 宝鸡 眉县	哦 一 看 就 知道 眉县 猕猴桃
哦 一 看 就 知道 眉县 猕猴桃	你 应该 是 个 男孩 换成 女孩 的 图像 吧 看 你 宣传 的 图像 应该 是 你 吧
以后 可以 从 你 这 买 了	感谢 你 的 支持
感谢 你 的 支持	没事
知道 为什么 叫做 桃李满天下 吗	可能 是 我家 的 桃李 全国 各地 都 有 伙伴 要 吧
可能 是 我家 的 桃李 全国 各地 都 有 伙伴 要 吧	这 是 个 完美 的 解释
那个 李子 好吃	李子 开 的 是 白花 么
李子 开 的 是 白花 么	是 的 这 就是 李花
萍姐 猜猜 我 是 谁	猜不出 是 小号 么
猜不出 是 小号 么	十三 村 的 十三姨 刚生 完 小孩 改行 了
十三 村 的 十三姨 刚生 完 小孩 改行 了	好久不见
最怕 买 到 假货 上 脸 很 可怕	太坏 了 化妆品 也 高仿
太坏 了 化妆品 也 高仿	高仿 的 东西 多 了 去
马油 棒棒 哒	马油 作用 很 强大
马油 作用 很 强大	你 更 厉害 让 我 更 了解 马油
你 更 厉害 让 我 更 了解 马油	暴力 么 么
心 痒痒 来 一罐 马油 面霜 可好	这个 可以 有 这 阵风 大 天天 吹 的 脸 疼 晚上 睡觉 前 涂抹 马油 就 很 管用
这个 可以 有 这 阵风 大 天天 吹 的 脸 疼 晚上 睡觉 前 涂抹 马油 就 很 管用	好像 我 有 一罐 不 知道 是不是 正版 的
好像 我 有 一罐 不 知道 是不是 正版 的	市面上 肯定 存在 假货 认准 我 说 的 那些 平台 购买 就 没 问题 了
市面上 肯定 存在 假货 认准 我 说 的 那些 平台 购买 就 没 问题 了	之前 中 的 橙色 装 也 不 知道 是不是 正版
嗯 嗯	么 么 哒
么 么 哒	图片 评论
厉害 了	马油 最棒
马油 最棒	没中过 快 带上 我
没中过 快 带上 我	能 不能 买 一瓶
能 不能 买 一瓶	买不起
买不起	女人 要 对 自己 狠 一点
女人 要 对 自己 狠 一点	果然 我 太 舍不得 了 还是 买 吃 的 犒劳 我 的 胃 吧
请 叫 我 . 足浴 界 的 . 小 清新	你好 小 清新
你好 小 清新	你好 丫李易峰
到底 是 为什么 呢	因为 你 没 送 我蓓 慈足 浴盆 丫
因为 你 没 送 我蓓 慈足 浴盆 丫	来 我 送 你 一盒 蓓慈 足浴 包
来 我 送 你 一盒 蓓慈 足浴 包	盒 不够 我要 盒 每天 配超 浓 足浴 汤 .
还 不是 因为 你 不是 程序员 你 以为 他 不 爱 搞 基	好 基友 . 很 高兴 认识 你 .
好 基友 . 很 高兴 认识 你 .	握 爪 穿 内裤 么
握 爪 穿 内裤 么	穿 不 穿 都 可以 . 反正 我 是 个 盆 .
穆然 已经 再刷 了 作者 微博 可以 看见	主要 我 是 想 换
主要 我 是 想 换	骚噶
感觉 好 艰苦	还好 吧 毕竟 我们 这里 有 新鲜 蔬菜 什么 的 吃 如果 在 干旱地区 就 真的 只能 吃 罐头 了
还好 吧 毕竟 我们 这里 有 新鲜 蔬菜 什么 的 吃 如果 在 干旱地区 就 真的 只能 吃 罐头 了	论 蔬菜水果 的 种类 没有 任何 地方 比得上 中国
论 蔬菜水果 的 种类 没有 任何 地方 比得上 中国	问题 我 都 在 这里 了 也 只能 想想 还好 没 在 干旱 地带
问题 我 都 在 这里 了 也 只能 想想 还好 没 在 干旱 地带	在 那边 是 执行 什么 任务 么 话 说 在 非洲 最 重要 的 是 小心 传染病
在 那边 是 执行 什么 任务 么 话 说 在 非洲 最 重要 的 是 小心 传染病	打工 嗯 这边 流行 疟疾 伤寒 霍乱 黄热病 和 利什曼病 所以 就算 来 旅游 也 务必 务必 务必 务必 打 疫苗 随身携带 清凉油
打工 嗯 这边 流行 疟疾 伤寒 霍乱 黄热病 和 利什曼病 所以 就算 来 旅游 也 务必 务必 务必 务必 打 疫苗 随身携带 清凉油	你 要 停留 多长时间 半年 一年
你 要 停留 多长时间 半年 一年	一年 明年 回国 就 不来 了 老板 太 那 啥 了
一年 明年 回国 就 不来 了 老板 太 那 啥 了	祝 你 坚持 住 啊 这 是 啥 公司
祝 你 坚持 住 啊 这 是 啥 公司	私人 小 公司 国内 叫 全位 工贸 全位 物流 香港 的 是 全位 国际 供应链 安哥拉 这边 是 叫 光大 , 反正 说 出来 大家 记得 避让 吧
私人 小 公司 国内 叫 全位 工贸 全位 物流 香港 的 是 全位 国际 供应链 安哥拉 这边 是 叫 光大 , 反正 说 出来 大家 记得 避让 吧	剥削 严重
鸡 和 羊 一点 也 不肥 那 怎么 好吃	不 好吃 啊 煮 出来 的 汤 一滴 油 都 没有
不 好吃 啊 煮 出来 的 汤 一滴 油 都 没有	听 你 的 描述 连 牛肉 也 那 有 鱼 吗 吃 点 鱼 兔子
听 你 的 描述 连 牛肉 也 那 有 鱼 吗 吃 点 鱼 兔子	有鱼 但是 买鱼 的 地方 比较 那 啥 没有 黑人 不敢 去 的 超市 里面 的 鱼 太贵 了 而且 不 新鲜
我 就 想 问问 霸道 少帅 是 坑 了 还是	没坑
没坑	那 我 继续 等待 么 么 哒
我 以为 是 青蛙	你 这 眼神
你 这 眼神	这俩 人 太帅 了
眼睛 很 亮	我 拍 的 夸 我
我 拍 的 夸 我	厉害 厉害 会 拍照 的 小 仙女
厉害 厉害 会 拍照 的 小 仙女	男神 约 拍 吗 给 你 找个 专业 的 来 拍 你 嘻嘻
男神 约 拍 吗 给 你 找个 专业 的 来 拍 你 嘻嘻	人丑 不 拍照
人丑 不 拍照	男神 说 笑 了
男神 说 笑 了	拍不动 这种 事情 留给 你 了
这个 妹子 挺 好看 的	就是 今天 我 在 搂 的 那个 呀
就是 今天 我 在 搂 的 那个 呀	知道 呀
你 也 有 需要 代购 的 一天	性别 女
性别 女	这话 说 的 好
哈哈 我 有 价格 很 便宜 的 武宁 日代	我 竟然 看 了 两遍 才 看 明白
我 竟然 看 了 两遍 才 看 明白	哈哈 我 微信 找 你
你 想想 我 昨天 发给你 的 淘宝 购物单	我 这 十天 就 吃掉 了 那么 多 我 现在 很 慌张 我 还 没 买 衣服
我 这 十天 就 吃掉 了 那么 多 我 现在 很 慌张 我 还 没 买 衣服	我 还 剩个 六七百 熬过 这个 月 就 又 可以 要钱 了
我 还 剩个 六七百 熬过 这个 月 就 又 可以 要钱 了	我 也 可 我 还 想 买 衣服 鞋子
我 也 可 我 还 想 买 衣服 鞋子	哈哈哈哈 我 已经 买 了 接下来 都 不 打算 在 花钱 了
哈哈哈哈 我 已经 买 了 接下来 都 不 打算 在 花钱 了	我 觉得 我 真的 要 开始 吃 食堂 不然 啥 都 买 不了
又 咋	搜淮 上
搜淮 上	撕来撕去 的 真是 不 消停 啊 支持 谁 的 都 有 啊 我 正在 看
撕来撕去 的 真是 不 消停 啊 支持 谁 的 都 有 啊 我 正在 看	那 是 啥
那 是 啥	哈哈 看 的 好 尴尬 凸
为什么 突然 被 人 打 掉	他们 打狗 卖狗肉
他们 打狗 卖狗肉	太 可恶 了 这些 人
请问 下 工期 是 多久	因为 是 通贩 所以 会 一个月 截止 一次 开始 整体 做 出来 现在 拍 的话 应该 到 差不多 要 二 月底 能 拿到
因为 是 通贩 所以 会 一个月 截止 一次 开始 整体 做 出来 现在 拍 的话 应该 到 差不多 要 二 月底 能 拿到	好 的
好 的	谢谢 关心
貌似 又 没有 弄 那个 微博 的 转发 抽奖 平台 不会 弄	那个 是 抽 的 时候 再 弄 的
那个 是 抽 的 时候 再 弄 的	是 这样 的 吗 哦 哦
怎么 都 在 修仙 啊	就是 你好 晚 还 没 睡 呀
就是 你好 晚 还 没 睡 呀	楼下 拆 房子 挖土 好 几天 了 我 等 他 挖 消停 了 才能 睡着 感觉 全天 小时 都 在 不停 的 挖 我家 那栋 楼 正前方
楼下 拆 房子 挖土 好 几天 了 我 等 他 挖 消停 了 才能 睡着 感觉 全天 小时 都 在 不停 的 挖 我家 那栋 楼 正前方	心疼 你 希望 赶紧 挖 完
心疼 你 希望 赶紧 挖 完	挖 完 就 把 他们 挖掘机 埋 了
挖 完 就 把 他们 挖掘机 埋 了	太虐 了 帮 你 填土
太虐 了 帮 你 填土	哎 你 也 赶紧 睡 吧 么 么 都 快 两点 了
哎 你 也 赶紧 睡 吧 么 么 都 快 两点 了	嗯 嗯 好 哒 晚安
上 新 打扰 了 跪谢 灯光 师傅 力 遵义 指环 果汁 官方 微博某 人大 尸人 迎风 拔牙 岛田森酒 第一 家具 家私 定制 工作室 厄夜 记录 三僚 腐朽 的 鱼 干风 十四 该 吃药 的 库洛洛 瓜瓜 哥哥 裁缝店 函大 嬸狐 空空	這風格 超特別 !
這風格 超特別 !	哈哈 谢谢 亲爱 的 我 还 挺 喜欢 的
哈哈 谢谢 亲爱 的 我 还 挺 喜欢 的	再 加上 景 真的 很棒 !
再 加上 景 真的 很棒 !	专门 去 了 景区 嘿嘿 好 在 四川 好看 的 地方 很多
专门 去 了 景区 嘿嘿 好 在 四川 好看 的 地方 很多	真 好 ! 有 機會 一定 也 要 帶漢子們 去 拍拍 拍
真 好 ! 有 機會 一定 也 要 帶漢子們 去 拍拍 拍	哈哈 等 你 的 美图 啊 超 期待
哈哈 等 你 的 美图 啊 超 期待	哈哈 心有 餘而力 不足 啊
上 新 打扰 了 跪谢 血茶 不 一样 的 变态 美蛭 子须 大弥 狗子 桥多 麻袋 西瓜籽 泫 泫 清清 小紫家 的 袖子 菌忆岑 一方 尘寰 手作店 无暇 祐 木井 远山 白 雨夜 的 老杰克 野 粽持 癫	呜呜 呜 你 的 图 总是 这么 大手笔 太美太美 啦
呜呜 呜 你 的 图 总是 这么 大手笔 太美太美 啦	出远门 拍 的 哈哈哈 也 是 酸爽 呢
出远门 拍 的 哈哈哈 也 是 酸爽 呢	不愧 是 干 大事 的 人
不愧 是 干 大事 的 人	还是 做 的 小事 不过 我会 加油 的
想 问下 太太 有木有 尺寸	不好意思 没有 呢
不好意思 没有 呢	好 哒 谢谢 太太 希望 能 抢 到 鬼 尺寸 吧
好 哒 谢谢 太太 希望 能 抢 到 鬼 尺寸 吧	加油 么 么
是 完售 了 吗	明 晚八点
明 晚八点	啊 居然 还 没 开始 太好了 谢谢 啊
啊 居然 还 没 开始 太好了 谢谢 啊	不 客气 加油 链接 在 评论
噫 不是 吧	多么 希望 是 限时 不 限量 呀
多么 希望 是 限时 不 限量 呀	哈哈 我 以前 也 不 限量 大家 一点 也 不 着急 还是 没买 那 我 还是 限量 好 了 毕竟 开 半个 月 纯属 浪费时间 啦 又 可以 想 新 衣服 呢
哈哈 我 以前 也 不 限量 大家 一点 也 不 着急 还是 没买 那 我 还是 限量 好 了 毕竟 开 半个 月 纯属 浪费时间 啦 又 可以 想 新 衣服 呢	可以 考虑 限时 或者 这样 这 段时间 内 不 限量 多好 呀
可以 考虑 限时 或者 这样 这 段时间 内 不 限量 多好 呀	但 有时候 材料 会 不够 还是 要 限量 哈哈
摸摸 如果 问 的 人多会 告诉 你 的 么	的 加 我 一個
的 加 我 一個	哈哈 问 的 多 我 看看
哈哈 问 的 多 我 看看	好 的 呢 抱 緊 太太 這樣 我 的 羽毛 頭就 有 用武之地 了
好 的 呢 抱 緊 太太 這樣 我 的 羽毛 頭就 有 用武之地 了	哈哈哈 羽毛 头 有点 期待
哈哈哈 羽毛 头 有点 期待	買 回來 完全 用不上 的
買 回來 完全 用不上 的	好像 自己 也 可以 做
好像 自己 也 可以 做	前提 是 我 不是 一個 手 殘帝認 真貌
前提 是 我 不是 一個 手 殘帝認 真貌	多 做 就 好 熟能生巧
分娃 福利 啊 咿个 粽吱 南城 十二 橘友雅	其实 是 叔叔 啦 嘿嘿
其实 是 叔叔 啦 嘿嘿	嗯 呢 偶 等 亲亲 出 的 好多 叔叔 衣服 都 好好看 所以 偶 只能 圈 给 基友们 了
嗯 呢 偶 等 亲亲 出 的 好多 叔叔 衣服 都 好好看 所以 偶 只能 圈 给 基友们 了	么 么 哒 主要 是 对 我 这个 风格 需求 一般 吧 哈哈 所以 就 没开
么 么 哒 主要 是 对 我 这个 风格 需求 一般 吧 哈哈 所以 就 没开	家里 小姐姐 头 其中 一个 是 男妆面 的 好 想要 这种 风格 啊
家里 小姐姐 头 其中 一个 是 男妆面 的 好 想要 这种 风格 啊	么
特别 想 说 其实 我 的 内心 对于 限量 还有 限时 都 是 森森 的 恨	每次 都 要 拼 手速 拼 人品 重点 是 好多 错过 了 都 再 难求 呜呜 呜
每次 都 要 拼 手速 拼 人品 重点 是 好多 错过 了 都 再 难求 呜呜 呜	嗷 这次 会 好点
嗷 这次 会 好点	嗯 嘛
嗯 嘛	干巴 爹
竟然 是 波德莱尔 没想到 能 在 首页 里 看待 他 的 文字 简直 想 哭	波德莱尔 是 我 的 最 爱 啊
波德莱尔 是 我 的 最 爱 啊	恶之花
恶之花	对 对 对 恶之花 还有 巴黎 的 忧郁 百读不厌
对 对 对 恶之花 还有 巴黎 的 忧郁 百读不厌	忍不住 挖出 书来 重新 看一遍 了 害怕
哈哈哈 哈哈哈 哈哈哈 哈哈哈 你 看 嘛 我 给 你 发 地址 啊	哈哈哈哈 哈哈哈 我 只是 友情 转发 我 不 看 漫画 靴 靴宝
哈哈哈哈 哈哈哈 我 只是 友情 转发 我 不 看 漫画 靴 靴宝	哈哈哈哈 哈哈哈哈 穴穴宝
为什么 我会 唱	是 晴天 呀
是 晴天 呀	恍然大悟 状 原来 是 我 逝去 的 青春 不禁 让 我 想起 了 夕阳 下 的 奔跑
恍然大悟 状 原来 是 我 逝去 的 青春 不禁 让 我 想起 了 夕阳 下 的 奔跑	我 也 是 步入 了 中年
我 也 是 步入 了 中年	这一 年龄 标准 让 我 明白 我能 怎么办 我 也 很 绝望 啊 是 何意
哈哈哈 哈哈哈 哪天 带 弟弟 一起	他 是 区加 不了 他
他 是 区加 不了 他	让 他 换
让 他 换	他 没 微信
他 没 微信	开 一个 快
同 想要 蛇立 空间 背景	私发 啦
私发 啦	谢谢 谢谢
求 一整套 表情 包	私发 啦 因为 评论 发 有 水印
私发 啦 因为 评论 发 有 水印	嗯 呐 谢谢
求 表情 包	要 哪个 哈哈哈哈 晚点 我 私发
要 哪个 哈哈哈哈 晚点 我 私发	要蛇立 要饭 那个 和 背景图
要蛇立 要饭 那个 和 背景图	私 发给你 啦
超超祝 你 生日快乐	佳梅 宝贝 居然 记得 我 生日 感动 谢谢 你
佳梅 宝贝 居然 记得 我 生日 感动 谢谢 你	我 本子 上 有 中秋 过后 第一天 中秋 快乐 哟
我 本子 上 有 中秋 过后 第一天 中秋 快乐 哟	同乐 宝贝
加 我	搞定
搞定	写 得 很 好
美美 美同 狐狸 娘求 问 壮士 哪家	谢谢 喜欢 壮士 微博名 是 努力 改变 的 熊
谢谢 喜欢 壮士 微博名 是 努力 改变 的 熊	嗯 嗯 感谢 抱住 么 么 哒
嗯 嗯 感谢 抱住 么 么 哒	不谢
然而 日本 樱花 还 没开	今年 武汉 的 樱花 提前 了 半个 月 然后 一直 在 下雨 哭成 狗
今年 武汉 的 樱花 提前 了 半个 月 然后 一直 在 下雨 哭成 狗	今年 日本 樱花 晚 了 半个 月 和 朋友 约片 都 是 秃 的
今年 日本 樱花 晚 了 半个 月 和 朋友 约片 都 是 秃 的	也 是 好惨 啊
买买 买	没钱 了
没钱 了	我 相信 你 还有 压箱底 的 钱
我 相信 你 还有 压箱底 的 钱	已经 没得 了
已经 没得 了	那 找 工作 上班 吧 摸头
我家 没有 这个 尺寸 但是 布布 有	我 得 考虑 下 这套
我 得 考虑 下 这套	更爱 日常 风
求问 衣服 出处	家德 古拉 官服 我 趁着 前两天 折时入 的 帅炸
家德 古拉 官服 我 趁着 前两天 折时入 的 帅炸	谢谢 好帅
求问 这个 月 还有 妆额 吗	三月 已经 接满 了 四月 的 要 日 晚上 点能 拍 这边 新手
三月 已经 接满 了 四月 的 要 日 晚上 点能 拍 这边 新手	完全 没 看出 哪里 新手 太触 了
完全 没 看出 哪里 新手 太触 了	感谢 喜欢
如果 我 去 的话 是不是 也 是 颜值 担当	你 要 听 实话 啊
你 要 听 实话 啊	是 啊
是 啊	你 想 多 了
你 想 多 了	你 稍微 打扮 打扮 我 你 就 知道 谁 是 颜值 担当 了
左右 手提 熊猫 .	咬 你 腿 儿 .
咬 你 腿 儿 .	放马过来 老子 根本 没有 在 害怕 .
春风 十里 又 见 你 棒棒 哒	每天 都 快乐 啊
每天 都 快乐 啊	嗯 每天 都 快乐
我 是不是 要接 一个 星河	你 可以 接 一个 西山 晚安
你 可以 接 一个 西山 晚安	晚安 老板
我 只 看过 人 飞出去 的	所以 你 想 玩儿 吗
所以 你 想 玩儿 吗	看要 和 谁 玩 咯
啊 太太 想画 穿 日常 便服 的 瑶瑶 么 不 戴帽子 的 那种	是不是 还 衣衫不整 的 那种
是不是 还 衣衫不整 的 那种	噫 突然 兴奋
噫 突然 兴奋	忍不住 开车 的 心 吧
忍不住 开车 的 心 吧	不 不 不 我 要 纯洁 我要 刀子 太太 来曦瑶 群 玩 么
不 不 不 我 要 纯洁 我要 刀子 太太 来曦瑶 群 玩 么	好 呀 群 号 是 多少
好 呀 群 号 是 多少	欢迎 太太 来 玩耍
比心心	画 完 了 感觉 身体 被 掏空 不 知道 画 啥 了
画 完 了 感觉 身体 被 掏空 不 知道 画 啥 了	先 休息
嗷嗷 好看 啊 太太 可以 抱 走 吗	可以
可以	跳 起来 么 么 哒
恶友组 久违 的 粮 啦	没 人 产粮 就 只能 自己 来 了
没 人 产粮 就 只能 自己 来 了	在 我 差点 饿死 的 时候 总算 吃 上 了 粮
我 . 怀桑 啊啊啊 啊	这 是 个 完全 妖化 的 怀桑
这 是 个 完全 妖化 的 怀桑	特别 喜欢 求怀桑 单人 大头贴
特别 喜欢 求怀桑 单人 大头贴	待 我 回头 把 他 的 身体 再 补 一点 出来 扇子 下面 的 部分 就 没画 了
待 我 回头 把 他 的 身体 再 补 一点 出来 扇子 下面 的 部分 就 没画 了	所以 我 只要 大头贴
怀桑美 哭 了	颜值 意外 逆天 他 的 位置 冷暖 光 交汇 脸上 色彩 很多 画 起来 巨带 感
颜值 意外 逆天 他 的 位置 冷暖 光 交汇 脸上 色彩 很多 画 起来 巨带 感	哇哇 哇哇 难怪 那么 美 那么 美 大大 你好 棒 啊 表白 笔芯
我 又 来 了 哈哈哈 哈哈哈	你 这 头像 贼
你 这 头像 贼	哈哈哈 哈哈哈 我 为了 不 拍 到 自己 都 扭曲 了
哈哈哈 哈哈哈 我 为了 不 拍 到 自己 都 扭曲 了	你 简直 有毒 应该 脖子 上 再 背个 蛙
你 简直 有毒 应该 脖子 上 再 背个 蛙	你 提醒 了 我
你 提醒 了 我	和 蛙 勾肩搭背
噫 瑶瑶 这 小 细腰	可惜 万恶 的 水印 打 在 了 我瑶妹 的 屁股 上
可惜 万恶 的 水印 打 在 了 我瑶妹 的 屁股 上	哈哈哈哈 哈哈哈哈 说明 你 标记 了 他
哈哈哈哈 哈哈哈哈 说明 你 标记 了 他	好 吧 瑶妹 我 的 抱 回去
他 就是 活该 有 阿瑶 这么 聪明 漂亮 的 孩子 是 他 的 福分 他 还 敢 轻贱 他 一切 因果 都 因为 金光 善 这 老 混蛋	就是 心疼 阿瑶
就是 心疼 阿瑶	终归是 出身 误 了 他
画工 真心 很 好 很 好 很 好 啊 我 觉得 瑶妹 真的 挺 招人 疼 好 吧 我 毫不掩饰 我 其实 全文 最 讨厌 的 是 金光 善	我 也 是 讨厌 金光 善 是 他害 了 我瑶妹
我 也 是 讨厌 金光 善 是 他害 了 我瑶妹	就是 所以 我 也 觉得 他 那种 法事 最 适合 他 的 哼哼 哼
就是 所以 我 也 觉得 他 那种 法事 最 适合 他 的 哼哼 哼	就是
好	咱家 闺女 和 蛙 开始 没羞没臊 的 的 幸福生活 了 吗
咱家 闺女 和 蛙 开始 没羞没臊 的 的 幸福生活 了 吗	嘿嘿嘿 是 呀 居然 有人 说 这个 蛙 是 我 的 化身
嘿嘿嘿 是 呀 居然 有人 说 这个 蛙 是 我 的 化身	因为 痴汉脸 吗
因为 痴汉脸 吗	可能 吧 哈哈哈 我 也 很 绝望
哈哈哈 我 也 想 穿 但是 没有 合适 的 花边 吧 哈哈哈	也 是 成品 的 太细 了 不过 一般 厂家 可以 定制 你 都 有 细款 就 更好 配线 和 制作 了 就是 数量 有 要求 我 上次 参商 的 寛 花边 就是 定制 的 亲 可以 考虑一下 真的 挺 好看 的
也 是 成品 的 太细 了 不过 一般 厂家 可以 定制 你 都 有 细款 就 更好 配线 和 制作 了 就是 数量 有 要求 我 上次 参商 的 寛 花边 就是 定制 的 亲 可以 考虑一下 真的 挺 好看 的	嗷好 的 你 参商
嗷好 的 你 参商	就是 我家 之前 出 那套 也 是 花边 没 合适 的 我 直接 找 厂子 订 的 天 左右 就 出货 了
就是 我家 之前 出 那套 也 是 花边 没 合适 的 我 直接 找 厂子 订 的 天 左右 就 出货 了	好 的 哈哈 我 差点 以为 你 去 了 呢 到 最后 就 只有 定制 呢 很多 东西 发现 都 不 适合 娃娃
好 的 哈哈 我 差点 以为 你 去 了 呢 到 最后 就 只有 定制 呢 很多 东西 发现 都 不 适合 娃娃	我 没 东西 摆摊 啊 就 没 去 玩 定制 的话 免不了 的 实物 肯定 很 好看
我 没 东西 摆摊 啊 就 没 去 玩 定制 的话 免不了 的 实物 肯定 很 好看	我 也 没 摆摊 就是 去 浪 了 一下 嘿嘿 实物 还好 衬衫 是 不错 的 材料 对 了 就是 好 的
我 也 没 摆摊 就是 去 浪 了 一下 嘿嘿 实物 还好 衬衫 是 不错 的 材料 对 了 就是 好 的	很 好看 放心大胆 的 去 做 不同 风格 支持
很 好看 放心大胆 的 去 做 不同 风格 支持	好 下次 又 想 换 风格 嘿嘿
总 觉得 他 刚 吸完 毒	捶 地 我 拍 不出 他 正直 脸来
捶 地 我 拍 不出 他 正直 脸来	我 觉得 不论怎么 拍 都 会 是 一副 刚 吸完 餍 足 的 感觉
能 请问 一下 图二 怎么弄 的 吗	扫描 全能王 或者 都 可以 喔
扫描 全能王 或者 都 可以 喔	再 打扰 一下 请问 怎么 用 吧 背景 全弄白 呀 如果 讲解 太 麻烦 就 不 麻烦 了
再 打扰 一下 请问 怎么 用 吧 背景 全弄白 呀 如果 讲解 太 麻烦 就 不 麻烦 了	唔 那 里面 有个 局部 功能 局部 调亮 就 可以 啦 多试 几次
唔 那 里面 有个 局部 功能 局部 调亮 就 可以 啦 多试 几次	好 的 谢谢
咦 阿青 不用 的 嘛	就是 买 的 灵华笔 刷
就是 买 的 灵华笔 刷	哇 我 也 买 了 笔刷 太多 完全 不 知道 画 什么 该用 哪个 而且 卡 的 不要 不要 的
哇 我 也 买 了 笔刷 太多 完全 不 知道 画 什么 该用 哪个 而且 卡 的 不要 不要 的	其实 用 自己 喜欢 用用 的 顺手 的 最好 了
我 告诉 基友 我 今天 要 骗 你 然后 她 提心吊胆 了 一天 我 啥 也 没干	哈哈哈哈 这个 好酷 我 是 最 低级 的 你 有 三块 钱 吗 我 在 超市 没 零钱 了
哈哈哈哈 这个 好酷 我 是 最 低级 的 你 有 三块 钱 吗 我 在 超市 没 零钱 了	你 难道 不是 评论 里 有 一辆 豪车 姿势 香艳 吗
你 难道 不是 评论 里 有 一辆 豪车 姿势 香艳 吗	但是 那 两个 人 真的 酣畅淋漓 欲仙欲死 看 我 的 眼神 多么 真诚
但是 那 两个 人 真的 酣畅淋漓 欲仙欲死 看 我 的 眼神 多么 真诚	是 是 是 姿势 巨 香艳
手感 如何 我 也 打算 换个 鼠标 来 着	挺 好 的 但是 男生 估计 会 有点 小 你 用 吧
挺 好 的 但是 男生 估计 会 有点 小 你 用 吧	猴
同款	我 还 没有 下 驱动 调 有没有 什么 经验 分享 一下
我 还 没有 下 驱动 调 有没有 什么 经验 分享 一下	直接 在 网页 或者 罗技 官网 搜 就行了 之前 上 罗技 官网 下 驱动 半天 没 下 下来 后来 随便 进 了 个 网站 下 的 用 起来 应该 也 是 原版
掉 到 后 再也 不敢 单排 了 每天 打打 快速 十分 无聊 感觉 要 了	我 在 等 弟弟 放假
我 在 等 弟弟 放假	没人 跟 我 一起 打 排位 哭 出声
没人 跟 我 一起 打 排位 哭 出声	单排 这 几天 翻车 严重 但是 有时候 单排 往上 上 也 挺 好 的
单排 这 几天 翻车 严重 但是 有时候 单排 往上 上 也 挺 好 的	我 单排 上 了 白金 就 一直 掉 大概 也 就 这 水平 了 绝望
罗技	太大 了 我握 着 不 舒服
太大 了 我握 着 不 舒服	噢 噢 我 一直 想 买来 着 不过 试握 一下 的确 比较 大 还 有点 重
太太 你好 请问 现在 还 能 排妆 吗	不好意思 亲 现在 暂时 停 一下
不好意思 亲 现在 暂时 停 一下	了解 啦 谢谢 蹲 等 开
太太 请问 可以 预约 月份 的 妆 吗 月份 孩子 一颗 头 的 妆 到 半年 了 想 找 你 换 妆 你 的 妆 太 种草 了	不好意思 月份 不 一定 有 别的 计划
不好意思 月份 不 一定 有 别的 计划	哦 哦 好 的 谢谢
请问 太太 现在 你 的 妆 排到 多久 了	月 啦
月 啦	嗯 嗯 了解 谢谢 太太
这次 开 到 什么 时候 呀	一直 呀
一直 呀	啊 啊 把 太好了 回点 血 就 来 送 啦
叫 我 这种 小 透明 都 有 僵尸 粉 而且 有 一个 人 我 加到 黑名单 里 了 还是 一直 显示 在 我 粉丝 里 不 晓得 怎么办 举报 也 没有 用	要 移除 粉丝 啦
要 移除 粉丝 啦	只有 拉黑 没有 移除 的 选项 不 晓得 是 什么 大人物
只有 拉黑 没有 移除 的 选项 不 晓得 是 什么 大人物	那 是 怎么回事 有毒
那 是 怎么回事 有毒	是 呀 我 就 隔 几天 举报 一次
你 的 到 了 我 的 还 没 呢	我 就是 给 你 买 的
我 就是 给 你 买 的	你别 吓 我 我 自己 买 了
你别 吓 我 我 自己 买 了	没有 我 手机 的 型号 所以 就 只 买 了 你 的
没有 我 手机 的 型号 所以 就 只 买 了 你 的	太爱 你 了 抱住 猛猛亲
你 最帅	在 看 你 之前 画 的 那个 蛋妆真美 和 兽 腿 一样 兽配 更 梦幻 星空 的 感觉 羡慕 很久 想 了 下 自己 好像 没 啥 可 让 你 这么 画 的 东西
在 看 你 之前 画 的 那个 蛋妆真美 和 兽 腿 一样 兽配 更 梦幻 星空 的 感觉 羡慕 很久 想 了 下 自己 好像 没 啥 可 让 你 这么 画 的 东西	这次 画 的 更 有 经验 哈哈哈
这次 画 的 更 有 经验 哈哈哈	没事 你 等 拔 叔 就 好 了
没事 你 等 拔 叔 就 好 了	哈哈哈 好
哈哈哈 好	对 我 就是 这样 安慰 下 自己 等 回头 入 再 给 你 看看 怎么 画好 嘿嘿 啦 啦 啦
对 我 就是 这样 安慰 下 自己 等 回头 入 再 给 你 看看 怎么 画好 嘿嘿 啦 啦 啦	猴
啊啊啊 啊啊啊 啊啊啊 啊 啊 我 也 想 跟 你们 娃聚	来 北京
来 北京	有雾 霾
有雾 霾	带 口罩
带 口罩	有 机会 去 就 找 你们
突然 被 这个 刷屏 所以 咋玩	就是 点开 热 搜榜
就是 点开 热 搜榜	椮 气气 已经 没有 了
好久 不 做 最晚 的 五路 了 好 想 当 那个 姑娘	不巧 这次 是 中午 出门 时候 坐 的 五路 不是 最晚 那班
不巧 这次 是 中午 出门 时候 坐 的 五路 不是 最晚 那班	为什么 不 配合 学妹 的 表演
为什么 不 配合 学妹 的 表演	该 配合 你 出演 的 我 视而不见
妹妹 可能 以为 你 想 勾搭 他	第一眼 被 无视 贼 尴尬
第一眼 被 无视 贼 尴尬	可能 是 内心 有点 小 悸动 装 矜持 呢
我 也 要好看 的 小 哥哥 拉 我 过去 站 着	站 完 了 你 可以 走 我 可是 会 被 三个 人轮 着 揍
站 完 了 你 可以 走 我 可是 会 被 三个 人轮 着 揍	好 了 好 了 表扬 你 做好事 不 留名
啊啊啊 我 也好 想 当辣个 吕孩纸 儿 但是 我 一想 你 要是 拽 我 拽 不动 那 该 多 尴尬 哈哈哈 哈哈	那有 啥 不行 我 就 两个 手使 使劲
那有 啥 不行 我 就 两个 手使 使劲	嘻嘻 嘻嘻 比心 比心 比心
妹子 应该 害羞 的 追 下车 我 我 想 谢谢 你 可以 给 我 手机号 么 一段 爱情故事 开始 咯	我 肯定 一 甩手 我 赶时间 别 耽误 我 上班
我 肯定 一 甩手 我 赶时间 别 耽误 我 上班	没 没关系 我 可以 去 你 单位 等 你 下班 的 脸红
我 就 不怕 了 因为 我 没 钱	我怕 差点 挨揍 过段时间 我要 拾起 我 的 健身 大业 了
我怕 差点 挨揍 过段时间 我要 拾起 我 的 健身 大业 了	怕 什么 怕 下次 记得 跟 妹妹 要 号码
怕 什么 怕 下次 记得 跟 妹妹 要 号码	那多 不好意思
那多 不好意思	孤独 终老 的 时候 会 好意思 吗
哈哈哈哈 这个 怎么 搞 的	这里 点 微博热 搜榜
这里 点 微博热 搜榜	让 我 试试
让 我 试试	你 的 是 什么
多想 把 我 的 肉分 二十斤 给 你	肉 的 位置 任 我 挑
肉 的 位置 任 我 挑	我 这 好不容易 养 的 肉 给 你 就 不错 了 还 挑 把 胸 留下 谢谢 了
我 这 好不容易 养 的 肉 给 你 就 不错 了 还 挑 把 胸 留下 谢谢 了	别 这样 我 还 小
别 这样 我 还 小	图片 评论
生日快乐 恭喜 恭喜 什么 录取	多读 一份 双 学历 累死
多读 一份 双 学历 累死	厉害 了 我 的 主编
厉害 了 我 的 主编	就是 太水 了 才 读 这个
哈哈哈 哈哈哈	毫无 形象
毫无 形象	这样 生活 比较 有趣
你 真 可爱	你 终于 说实话 了
你 终于 说实话 了	说谎 了
说谎 了	明明 就是 大 实话
明明 就是 大 实话	你 是 可爱 的
怎么 啦	我 觉得 我 很 有幸 不过 你 的 昵称 亮 了
我 觉得 我 很 有幸 不过 你 的 昵称 亮 了	亮 就 对 了
不 开心	大妹 砸 咋 滴 啦
大妹 砸 咋 滴 啦	男神要 去 服役 了
男神要 去 服役 了	听说 里面 好几个 都 要 去 服兵役 咯
听说 里面 好几个 都 要 去 服兵役 咯	今天 是
头发 稀少	对 的 哦
对 的 哦	记得 多 吃 黑豆
记得 多 吃 黑豆	好 的 好 的
好 的 好 的	吃屎
吃屎	你 再 叫 我 吃 你 我 就 我 就 . 啊
你 再 叫 我 吃 你 我 就 我 就 . 啊	你 就 咋 滴
不止 你们 三个 啊	短 鲁班 的 闺蜜 在 农林 读书 哦
短 鲁班 的 闺蜜 在 农林 读书 哦	短 鲁班
这手	都 是 筋 哈哈哈
都 是 筋 哈哈哈	挺 好看 的
你们 补考 考完 啦	对 呀 周六
对 呀 周六	哎呀 也 不 知道 我们 什么 时候 补考 好 心痛 啊
黃 哥	很 黄 很 暴力
很 黄 很 暴力	怎么 说
怎么 说	不然 黄哥 这个 绰号 真的 想 笑
明明 就是 厦大 的 拍 得 跟 游客 一样	一个 人 的 旅游
一个 人 的 旅游	请 你 吃 碗 沙茶 面 他 一个 冒险 一个 人 想着 一个 人
你 也 加油 挖 帅气 的 小学 弟	学姐 过年 回 三明 了 吗
学姐 过年 回 三明 了 吗	嗯 啊 回 了
嗯 啊 回 了	有 打球 吗
有 打球 吗	我 是 渣 渣 有时候 会去 下洋 玩儿 会儿
我 是 渣 渣 有时候 会去 下洋 玩儿 会儿	星期 几 啊 哈哈
星期 几 啊 哈哈	有体 就 去 没有 固定 的 时间 年轻人 早点 睡 不要 熬夜
棒棒 的	哈哈哈
哈哈哈	以前 我们 说好 如果 你 参加 了 奥运会 我 就 去 采访 你 哈哈 如今 我 已经 学上 了 广播电视 新闻学 的 专业 等 你 了 高考 加油
以前 我们 说好 如果 你 参加 了 奥运会 我 就 去 采访 你 哈哈 如今 我 已经 学上 了 广播电视 新闻学 的 专业 等 你 了 高考 加油	那个 专业 好玩 吗
那个 专业 好玩 吗	好玩 也 累
好玩 也 累	我 也 挺 喜欢 的
美女 是 纹眉 了 么 求 介绍	对 啊 要 微信 吗
对 啊 要 微信 吗	不胜感激 谢谢
早年 的 陈晓 怎么 是 光头 啊 你 又 删微博 了	不是 早年 是 现在
不是 早年 是 现在	你 写 的 早年 情诗 节选 啊
有点像 贾静雯	就是 啊
就是 啊	啊 好 吧 感觉 比 以前 成熟 了 然后 变成 双眼皮 了 没 认出来
厉害 了	赶紧 约 我 兄弟 啊 你 还 在 等 什么
赶紧 约 我 兄弟 啊 你 还 在 等 什么	害羞
赞 哦	嗯 诺 得 回 北京 长 鼻毛 了
嗯 诺 得 回 北京 长 鼻毛 了	哈哈 这是 什么 梗
哈哈 这是 什么 梗	回 北京 雾 霾 天 自强不息 啊 哈哈哈哈
乱说	你 在 说 什么
你 在 说 什么	我 又 在 开会 嘞
因为 你 在 思恋 我	好烦 我 今天 回去 开会
好烦 我 今天 回去 开会	我 上班 哈哈哈
我 也 想 看	你 啥子 都 想 看
你 啥子 都 想 看	你 个 老年人 能 欣赏 得来
薄夏 你们 的 老公	我 遇上 知音 了 吗
我 遇上 知音 了 吗	从小到大 也 是
哎呀 四百多 暂时 还是 算了	暂时
暂时	等 着 我 发家致富
等 着 我 发家致富	必须 等
找 啦 不能 退 差价 但是 因为 在 天 无 理由 退换货 的 时间 内 可以 退货 然后 但是 想 重新 拍 一双 发现 已经 断码 了	先 退货 然后 你 随便 拍 一个 让 他们 给 你 发个 空 的 这个 直接 接受
先 退货 然后 你 随便 拍 一个 让 他们 给 你 发个 空 的 这个 直接 接受	不行 啦
找 卖家 退 差价 撒	可以 这样 吗 可能 不得 理 我 哈哈哈
可以 这样 吗 可能 不得 理 我 哈哈哈	可以 大多数 都 还是 要 退 不然 就 给 差评 哈哈哈
可以 大多数 都 还是 要 退 不然 就 给 差评 哈哈哈	算啦 都 给 了 好评 了
算啦 都 给 了 好评 了	你 可以 去 问 了 试
你 可以 去 问 了 试	好 试一下 呢
你 是 谁	是 你
是 你	拒绝
居然 会 听 哈族歌 呀 哇 偶	音乐 无国界
音乐 无国界	哈哈哈 有 道理
又 去 看 五月天 了	是 的 你 想 去 吗 听说 可能 会 有 福州
是 的 你 想 去 吗 听说 可能 会 有 福州	我要 留点 钱 去 风暴 电 音节
我要 留点 钱 去 风暴 电 音节	蹦迪
笑点 在 哪	看来 你 不 懂 时尚
看来 你 不 懂 时尚	哈哈哈 你 才 知道
哇哇 这是 哪里	这里 是 福建 泉州 承天寺
这里 是 福建 泉州 承天寺	喔 喔
郁闷 啊	今天 有空 如果 通知 一下 可以 去 帮忙 的
今天 有空 如果 通知 一下 可以 去 帮忙 的	今天 下雨 先不整 谢谢 你
今天 下雨 先不整 谢谢 你	这 几天 要 上班 了
这 几天 要 上班 了	佛 的 我们 都 在 灾后 第一线
什么 时候 来 厦门	你 都 在 厦门 吗
你 都 在 厦门 吗	对 呀
土豪 吃 那么 好	打趣
打趣	一道 菜 都 够 我 吃 顿 麦当劳 了
那扣 了 的 钱 能 回来 吗	最近 全国 都 是 免费 骑行 啊
最近 全国 都 是 免费 骑行 啊	是 一周 前扣 的 十个 多 小时 啊
你 才 六 说不上 千 也 谈不上 万	就 问 你 怕不怕
就 问 你 怕不怕	什么 叫 怕
什么 叫 怕	好 怕怕 噢 怕死 了 可以 了 吧
好 怕怕 噢 怕死 了 可以 了 吧	哈哈哈 好 假 阿
哈哈哈 好 假 阿	不要 以为 长得 好看 就 可以 这 样子
夏天 夏天 悄悄 来临 没有 小 秘密	今天 晚上 出奇 的 多 大概 是 要 地震 了 吧
今天 晚上 出奇 的 多 大概 是 要 地震 了 吧	呵呵 别闹
呵呵 别闹	啊 哈哈哈 开个 小 玩笑
又 矫情	好 了 该 睡觉 了
好 了 该 睡觉 了	洗衣机 还 在 洗衣服
洗衣机 还 在 洗衣服	说好 十点 睡 的
说好 十点 睡 的	那 衣服 你 晾
那 衣服 你 晾	那 你 去 睡 吧
年 兜 莫 返家 莫某 冬至 莫 返家 莫祖	你们 是 冬至 扫墓 吧 所以
你们 是 冬至 扫墓 吧 所以	是 啊
是 啊	你们 和 德化 莆田 等 个别 地方 是 这 样子 大部分 是 清明 所以 都 没错
现在 多少 了	整 一 星期 晚上 没有 吃饭 了 早上 称 了 一下 一斤 没有 瘦
整 一 星期 晚上 没有 吃饭 了 早上 称 了 一下 一斤 没有 瘦	她 现在 不卖 了 吗
快 去 啃 你 的 猪蹄 去 吧	你 头像 上 有 苍蝇 可怕
你 头像 上 有 苍蝇 可怕	长得帅 的 人才 有
张翰 眼睛	有话 好好 说
有话 好好 说	我 都 没 发图
我 都 没 发图	别吓人 了
虐狗 奥	成功 喂 粮
成功 喂 粮	算连 挂料 办 挂料 办
羡慕 有个 正常 男朋友	你 的 男朋友 多甜
你 的 男朋友 多甜	没 把 我 气死
没 把 我 气死	哈哈哈 那 也 是 爱 你
坐 办公室 啦	哈哈 享受 一把
哈哈 享受 一把	爽 的 你
好 了 知道 号 你 请 我 吃 啥 了	哈哈 我 现在 巨想 吃 米线
哈哈 我 现在 巨想 吃 米线	好 了 就 等 你 带我去 了
好 了 就 等 你 带我去 了	快上车
快上车	哦 不靠 谱
抠 图 抠 的 超好	不好 还有 白 的 但是 没 耐心 了
不好 还有 白 的 但是 没 耐心 了	我 也 是 . 每次 抠到 一半 算了 哈哈哈哈 反正 微 博会 缩图
我 也 是 . 每次 抠到 一半 算了 哈哈哈哈 反正 微 博会 缩图	对 哈哈哈
喜欢 菠萝	因为 你 是 菠萝 妹
因为 你 是 菠萝 妹	你 又 是 怎么 知道 滴
你 又 是 怎么 知道 滴	忘 了 但是 知道
哇 哦 夸 一万次	谢 一万次
谢 一万次	抱抱
我 也 超 喜欢 图	老子 忘 了 给 你 录 了 哈哈哈哈 哈哈哈
老子 忘 了 给 你 录 了 哈哈哈哈 哈哈哈	你 是 妈个 猪
你 是 妈个 猪	明天 明天 哈哈哈哈
我 也 想养	寝室 不能 养
寝室 不能 养	我们 也 是
以后 这种 状态 要 多发	为何 呢
为何 呢	看 妹子 啊
再 夸 一次 嘻嘻 嘻龙	嘻嘻 晚安 兔子
嘻嘻 晚安 兔子	晚安
我 又 来 了	怎么 还 不 睡 啊
怎么 还 不 睡 啊	我 在 思考 人生
我 在 思考 人生	咋 了
咋 了	我 肚子饿 了
我 肚子饿 了	哈哈哈 哈哈哈 哈哈哈 哈哈哈 哈哈哈 哈哈哈 哈哈哈 哈哈哈 哈哈哈 哈哈哈 哈哈哈 哈哈哈 哈哈哈 我 也 饿 了 呜呜 呜
哈哈哈 哈哈哈 哈哈哈 哈哈哈 哈哈哈 哈哈哈 哈哈哈 哈哈哈 哈哈哈 哈哈哈 哈哈哈 哈哈哈 哈哈哈 我 也 饿 了 呜呜 呜	唉 人生 苦短 夏天 要来 了 不能 再肥 了
唉 人生 苦短 夏天 要来 了 不能 再肥 了	肉 藏不住 了 害
肉 藏不住 了 害	很 伤心 所以 想 多 吃 一点
很 伤心 所以 想 多 吃 一点	哈哈哈哈 睡醒 了 再 吃 晚安
哈哈哈哈 睡醒 了 再 吃 晚安	保瘦 晚安 阿龙
马文评 天气预报 说 明天 有 暴雨	养 乌龟 吧 真的
养 乌龟 吧 真的	我养 死 过 乌龟 说 了 怕 你 不信
资深 照骗	这样 才 对得起 你 的 评论 嘛
这样 才 对得起 你 的 评论 嘛	哈哈哈哈 你 现在 不 学好 天天 和学 油嘴滑舌
哈哈哈哈 你 现在 不 学好 天天 和学 油嘴滑舌	不许 你 这么 说 我家
不许 你 这么 说 我家	辣鸡
辣鸡	来 打 我 呀
来 打 我 呀	听 一次 听 有人 提 这种 要求
喜欢 草莓	也 是 甜甜的
也 是 甜甜的	哈哈哈 是 你
哈哈哈 是 你	你 是 甜 的 我 是 酸 的
洋洋 洋洋 小小的 草莓 仙子 衣锦夜行 来 喷 啊	喷 啥
喷 啥	卡顿
卡顿	你 在 说 啥
怀 了	她 小姨 还 不 拿 红包 干嘛
她 小姨 还 不 拿 红包 干嘛	你 倒 是 生 啊
你 倒 是 生 啊	生 出来 吓死 你
生 出来 吓死 你	才 不会
才 不会	太丑 了 塞 回去
太丑 了 塞 回去	先给 红包 我 再 塞 回去
请问 这个 瞪眼 的 帅哥 是 谁 啊	哪里 有 帅哥 我 怎么 只 看到 了 美女
哪里 有 帅哥 我 怎么 只 看到 了 美女	眼神 出现 了 问题 这 是 哪 两位
眼神 出现 了 问题 这 是 哪 两位	一位 美女
一位 美女	请 赐予 这位 帅哥 好运 吧
哼 还 直接 艾特 了	怕 你 看不见
怕 你 看不见	我 看见 了 看 的 很 清晰
我 看见 了 看 的 很 清晰	哈哈哈 可别亮 瞎眼
你 有 病	我怕 你们 错过 新闻
我怕 你们 错过 新闻	这 啥时候 拍 的
这 啥时候 拍 的	是 旧闻
是 旧闻	嘘别 让 柯子 知道
你们 干嘛 呢	你 指 的 谁
你 指 的 谁	你们 都 在 干嘛
你们 都 在 干嘛	哈哈哈哈 我们 一起 嗨 起来 一起 摇摆
他 说 你 小小的 草莓 仙子	咱俩 把 他 剁 剁 腾 了 吃 了 吧
咱俩 把 他 剁 剁 腾 了 吃 了 吧	人 肉 馅饼
这是 集体 感冒 的 节奏 吗 一波接 一波	难道 是因为 我 逛 了 一圈 带动 的
难道 是因为 我 逛 了 一圈 带动 的	还有 一分钟 下班
还有 一分钟 下班	我 上班 的 一天 授权 核 印鉴 看剧 清钞 碰库 不要 问 我 为什么 有 看剧 这个 选项
哇 感觉 好 好吃	是 滴 我 朋友 自己 做 的 蒜 香 排骨 是 她 妈妈 做 的 大饱口福
是 滴 我 朋友 自己 做 的 蒜 香 排骨 是 她 妈妈 做 的 大饱口福	大 晚上 好 洗脑 更 饿 了
大 晚上 好 洗脑 更 饿 了	哈哈哈哈 来 成都 我 做 给 你 吃
哈哈哈哈 来 成都 我 做 给 你 吃	我 清明 一周 假 还 想着 要 不要 去 成都 找 你 玩
我 清明 一周 假 还 想着 要 不要 去 成都 找 你 玩	可以 呀 我们 明天 微信 私聊 讨论一下
哟 你 还 知道 给 我 评论 啊	但是 我 一直 在 跟 你 聊 啊 这 可比 评论 重要 的 多
但是 我 一直 在 跟 你 聊 啊 这 可比 评论 重要 的 多	啧啧 啧啧
你 走开	往 哪儿 走
往 哪儿 走	爱往 哪 走 往 哪 走
萌	未必 不萌
未必 不萌	萌萌萌
第一个 把 你 投出去 你 这匹 铁狼	吓 我 一 跳 法克 您
吓 我 一 跳 法克 您	你 忘 了 我们 是 最合 了 吗
你 忘 了 我们 是 最合 了 吗	好好 吸猫别 废话
好好 吸猫别 废话	好 的 我 回家 吸猫 会录 视频 给 我 的 可爱 甘 的
周天 住 在 武汉 吗	不得 行 我 周六 还要 送 一只 猫儿 去 麻城 下午 跟 你 摆 这个 事情
不得 行 我 周六 还要 送 一只 猫儿 去 麻城 下午 跟 你 摆 这个 事情	喔 哦 好
节日快乐	清明节 快乐 耶耶耶
清明节 快乐 耶耶耶	你 有点 毛病 吧
哇 这么 可爱	憋 老 夸 我
憋 老 夸 我	哈哈哈 我 尽量 克制 一点
哈哈哈 我 尽量 克制 一点	哈哈哈 哈哈
学姐 好 漂亮	学弟 生日快乐
学弟 生日快乐	这么晚 的 祝福 我 很 怀疑 你 的 诚心 啊
这么晚 的 祝福 我 很 怀疑 你 的 诚心 啊	好话 不怕 晚 哈哈哈哈
好话 不怕 晚 哈哈哈哈	哈哈 谁 让 你 是 我 学姐 那 你 说 的 都 对
收银员 可以 的	都 太 可以 了
都 太 可以 了	别的 没见 过
别的 没见 过	有 两个 比 收银 小哥 还 好看 的
有 两个 比 收银 小哥 还 好看 的	回去 的 时候 会 一会
回去 的 时候 会 一会	可以 可以
那 我 是不是 就 可以 直接 被 招 了 哈哈	都 不用 面试 了 哈哈哈哈
都 不用 面试 了 哈哈哈哈	可以 的 表哥 不愧 我 是 你 的 表弟
可以 的 表哥 不愧 我 是 你 的 表弟	表哥 很 欣慰
因为 前女友 不理 他 姐姐 么	没 没
没 没	说不定 哦
求 风衣 链接	就是 我 去年 穿 的 那件 薄 的 啊
就是 我 去年 穿 的 那件 薄 的 啊	啊 想 起来 了
一样 难	你 这 是 改 了 个 啥 名 李气 的
你 这 是 改 了 个 啥 名 李气 的	你 甭管
借口 理由	没错 我 就是 一个 喜新厌旧 的 女孩
没错 我 就是 一个 喜新厌旧 的 女孩	完蛋 了 丧失 英语 能力 了
给 技术 满分 的 胖丹 一个 辣吻 白羊	胖丹
胖丹	总有一天 这个 称呼 会 从 胖子 变成 瘦子 的
总有一天 这个 称呼 会 从 胖子 变成 瘦子 的	不 开心
不 开心	期待 你 变身 的 那一刻
你 也 还 在家 啊	嗯 呀 过 几天 走 你 呢
嗯 呀 过 几天 走 你 呢	我 也 是 号 走
啧啧 啧	是不是 觉得 我 简直 是 专一 哈哈哈哈
是不是 觉得 我 简直 是 专一 哈哈哈哈	专一 的 让 我 无话可说
哦 天 哪 你 的 眉毛	怎么 怎么 了
怎么 怎么 了	长 出来 很多 啊
我 始终 学 不会 画 眉毛 好忧桑	去 纹眉 哈哈哈哈
去 纹眉 哈哈哈哈	这事 更 纠结 我姐 就是 做纹 绣 的 可 我 不 相信 她 技术 因为 真的 不怎么样 我 又 不能 再 花钱 去 其他 地方 做 真是 尴尬
这事 更 纠结 我姐 就是 做纹 绣 的 可 我 不 相信 她 技术 因为 真的 不怎么样 我 又 不能 再 花钱 去 其他 地方 做 真是 尴尬	哈哈哈哈 这 就 尴尬 了
今天 不 上班	我 是 周一 休息 啊
我 是 周一 休息 啊	这么 清闲 我 今天 上班 像 打 游击战
这么 清闲 我 今天 上班 像 打 游击战	你 也 有 休息天 啊 这 是 我 昨天 发 的 微博 呢
你 也 有 休息天 啊 这 是 我 昨天 发 的 微博 呢	我 说 呢 你 怎么 莫名其妙
你们 又 快 生日 了 你 是 月 对 吧	我 农历 .
我 农历 .	我 知道 没 这么 笨
肉肉 是 玉露 嘛 都 变 颜色 了 呢	好像 不 叫 玉露 哎 我 不 知道 她 买 的 时候 就是 这个 颜色 好像 没长
好像 不 叫 玉露 哎 我 不 知道 她 买 的 时候 就是 这个 颜色 好像 没长	我 那个 都 不 知道 叫 什么 名字 随便 买 的 变 颜色 了 才 养得 好 啊
我 那个 都 不 知道 叫 什么 名字 随便 买 的 变 颜色 了 才 养得 好 啊	还有 这样 的 讲究 我 是 对 植物 一窍不通 的
还有 这样 的 讲究 我 是 对 植物 一窍不通 的	我 也 是 对 多 肉 一点 没 了解 过 随便 买 的 后来 稍微 百度 了 一下 不同 品种 有 不同 的 养植 方法 多肉会 随着 气温 变化 而变 颜色 除了 夏天 中午 特别 热要 避免 暴晒 一般 都 要 晒太阳 的 浇水 土壤 都 有 讲究 不然 为什么 多肉 不太好 养
我 也 是 对 多 肉 一点 没 了解 过 随便 买 的 后来 稍微 百度 了 一下 不同 品种 有 不同 的 养植 方法 多肉会 随着 气温 变化 而变 颜色 除了 夏天 中午 特别 热要 避免 暴晒 一般 都 要 晒太阳 的 浇水 土壤 都 有 讲究 不然 为什么 多肉 不太好 养	啊 我 天 我 还 以为 多肉 跟 仙人掌 一样 顽强 呢
啊 我 天 我 还 以为 多肉 跟 仙人掌 一样 顽强 呢	好像 不太 一样 虽然 也 是 半个 月 不 浇水 也 没事儿 的
好像 不太 一样 虽然 也 是 半个 月 不 浇水 也 没事儿 的	看来 肉肉 还是 没 那么 坚强 的 哈哈
正粤 粥 铺 还有 多肉 能 晒太阳 么	她 吃 的 松花江 饺子
她 吃 的 松花江 饺子	哦 漏 我 看到 边上 的 饼 自动 代入 为 毛 你 可以 把 棒棒糖 拍 得 这么 好看
哦 漏 我 看到 边上 的 饼 自动 代入 为 毛 你 可以 把 棒棒糖 拍 得 这么 好看	因为 技术 哈哈
可 给 我 找到 了 想 给 兄弟 的 爱情 一个 祝福 还要 专门 跑 兄弟 女票 微 博里 点赞 简直 了 简直 了 其实 你们 俩 之前 我博 一直 和 我 在 一起 的 我 恨 你	我 我 我 . 错 了
我 我 我 . 错 了	我 原谅 你 了
耐斯 不耐斯	稳 还是 你 稳
稳 还是 你 稳	真是 个 段子 大 兄弟
最近 生活 好惨 借 我点 钱 吧	去 祸害 大英帝国 的 人民 去
去 祸害 大英帝国 的 人民 去	有 异性 没 人性
有 异性 没 人性	借 你 人民币 又 花 不成 我 给 女王 说 了 你 去 白金汉宫 拿 吧 二百万
借 你 人民币 又 花 不成 我 给 女王 说 了 你 去 白金汉宫 拿 吧 二百万	刚好 明天 去 伦敦 我会 去 拿 的
瘦 啦 瘦 啦 镜子 好看	好想你 阿
好想你 阿	是 哇 什么 时候 来 找 我 玩 啊
是 哇 什么 时候 来 找 我 玩 啊	等 个 周末 去 找 你 吃 好吃 的 哇
字 好看	这字 哪里 好看
这字 哪里 好看	很 可以 的 棒棒 哦
它 飘 了 一个月 多 两天	最终 还是 回来 啦
最终 还是 回来 啦	跨过 山 和 大海
哈哈哈哈 哈哈哈哈 哈哈哈 我 也 想要	来来 微信 撩 你
来来 微信 撩 你	这么 厉害 来来来
无聊	你 咋 能 看出 我 的 套路 呢
你 咋 能 看出 我 的 套路 呢	就 你 那 点儿 小 伎俩 骗骗 别人 还 行
就 你 那 点儿 小 伎俩 骗骗 别人 还 行	女人 何苦 为难 女人
服服服 听 得 最 多 的 就是 说话 啊	哈哈哈 哈哈 稳 了 稳 了
哈哈哈 哈哈 稳 了 稳 了	突然 发现 你 又 换 手机 了
突然 发现 你 又 换 手机 了	这 关注点
这 关注点	哈哈哈哈
一碗 好 狗 粮 下肚	嘻嘻 情人节 快乐 啦 毛毛
嘻嘻 情人节 快乐 啦 毛毛	活捉 夜猫子
活捉 夜猫子	哈哈
回去 啦	嗯 哪 你 呢
嗯 哪 你 呢	我过 阵子 回
日系 妹子 终于 回来 了	讨厌 你 又 要 看见 戴眼镜 的 我 了
讨厌 你 又 要 看见 戴眼镜 的 我 了	我 很 是 兴奋 请 快 约 起来
等 啥 等 有 啥 好 等 的 海南 出 太阳 齁 热 等 鸡毛 等	听 八卦 吗
听 八卦 吗	再信 你 我 就是 狗
再信 你 我 就是 狗	从 去年 到 今年 你 已经 信 了 三次 了 我 等 着 你 下次 学 狗叫
海角 七号	错 啦 花样年华
错 啦 花样年华	哈哈哈 那 是 我 记错 啦 你好 美 喔
哈哈哈 那 是 我 记错 啦 你好 美 喔	哈哈哈哈 哈哈哈哈 你 是不是 在 转移 话题
哈哈哈哈 哈哈哈哈 你 是不是 在 转移 话题	嘻嘻 快 说 我 是不是 很 可爱
嘻嘻 快 说 我 是不是 很 可爱	哈哈哈 哈哈 对 对 对 夸 你
有人 哭 成 花猫	那人 是 谁
那人 是 谁	我 女儿
那 我 是 断肠人	刘玮晗 今天 撸 猫 了 吗
刘玮晗 今天 撸 猫 了 吗	撸 了 你
看来 你 很 生气 啊 四天 了 都 不 更博	只是 懒 而已 这算事 吗
只是 懒 而已 这算事 吗	图片 评论
图片 评论	图片 评论
美女 你好	这 是 男 的 吧
这 是 男 的 吧	哈哈
你 为啥 现在 天天 给 智障 们 撕 逼	别 把 很少 了 好 嘛 发完 开始 还好 晚上 一看 节奏 成 这 了 我 也 是 服气
别 把 很少 了 好 嘛 发完 开始 还好 晚上 一看 节奏 成 这 了 我 也 是 服气	反正 你 又 不 知道 他 是 谁 瞎说 呗 现在 跟风 狗 多 的 很
反正 你 又 不 知道 他 是 谁 瞎说 呗 现在 跟风 狗 多 的 很	遍地 跟风 狗 啊 要是 下午 看眼 带 带 节奏 啥 的 不会 这样
遍地 跟风 狗 啊 要是 下午 看眼 带 带 节奏 啥 的 不会 这样	秒 回 的 重要性
秒 回 的 重要性	谁 知道 他们 能 撕起来
老哥 可以 需要 代喷 服务 请 我	那 还 接 业务 哪
那 还 接 业务 哪	小号 已经 备好
小号 已经 备好	专业 的
专业 的	那 你 看
正常 网上 的 跟风 一波 反制 节奏 后 开始 给 萨德洗 的 水军 就 开始 上班 了	这洗 的 看 的 我 都 开始 给 韩国 换位 思考 了
这洗 的 看 的 我 都 开始 给 韩国 换位 思考 了	拿 人 钱财 替人 洗 地 然而 大部分 还是 被 带 节奏 的 吃 瓜们
拿 人 钱财 替人 洗 地 然而 大部分 还是 被 带 节奏 的 吃 瓜们	真是 傻子 太多往 哪 吹 往 哪 跑
你 不是 当兵 走 了	记错 了 吧 我 没 当兵 呀
记错 了 吧 我 没 当兵 呀	我 擦 我 混乱 了
我 擦 我 混乱 了	别的 哥们 吧
别的 哥们 吧	对 郑州 的 信息工程 大学 的 无 军籍 学员 毕业 了 就 去 部队 当兵 了
加油 以后 买架 开开	这 一架 得个 亿 吧
这 一架 得个 亿 吧	等 个 三五十年 便宜 了 再 买
等 个 三五十年 便宜 了 再 买	说 得 跟 能 卖 一样
是 阿中 木瓜 奶 么	对 啊 对 啊
对 啊 对 啊	难怪 那么 熟悉 啦 几年 没去 了
难怪 那么 熟悉 啦 几年 没去 了	杯子 都 换 了
我姐 就是 厉害	你姐 是 谁
你姐 是 谁	呢 我 博哥 就是 厉害
那 真是 要死 了	我 也 觉得 要死 了
我 也 觉得 要死 了	唉 为什么 要 这样 呢
来 你 寝室 找 你 跳舞	脱脱 给 你 直播 王者 荣耀
脱脱 给 你 直播 王者 荣耀	哈哈哈哈 杀 杀 杀 防御 防御
哈哈哈哈 杀 杀 杀 防御 防御	我 听 出来 她 在 玩 鲁班
我 听 出来 她 在 玩 鲁班	虽然 不 懂 鲁班 做 什么 预祝 她 不要 再败 了
虽然 不 懂 鲁班 做 什么 预祝 她 不要 再败 了	我 一个 从来 没 打过 王者 荣耀 的 人 现在 对 王者 荣耀 的 了解 也 挺 深 了
我 一个 从来 没 打过 王者 荣耀 的 人 现在 对 王者 荣耀 的 了解 也 挺 深 了	哈哈哈 哈哈哈 是 啊 音乐 一 出来 就 都 知道 啦
梁 也 照 了	嘻嘻 可以 拼 一组 照片 了
嘻嘻 可以 拼 一组 照片 了	人 情侣
就 知道 你会 发微博	不然 充 会员 干嘛
不然 充 会员 干嘛	记得 向 鲁迅 要 签名
记得 向 鲁迅 要 签名	他 老婆 不 答应
美女 真 好看	宝贝 怀孕 了 不能 玩 手机 滴
宝贝 怀孕 了 不能 玩 手机 滴	喔 唷 消息灵通 啊
喔 唷 消息灵通 啊	主理 人 电子 烟 抽抽
主理 人 电子 烟 抽抽	拉 黑 吧 再也 不 回头
拉 黑 吧 再也 不 回头	我要 坐 着 你 的 奔驰 去 拉萨 爱 你
我要 坐 着 你 的 奔驰 去 拉萨 爱 你	去 你 妈
去 你 妈	明天 请带 张景硕 去 晒 日头
明天 请带 张景硕 去 晒 日头	好 的 老板
钱 打 支付宝 吧	昨晚 不是 给 了 吗 在 最 激烈 的 时候 扔给 你 了
昨晚 不是 给 了 吗 在 最 激烈 的 时候 扔给 你 了	不是 本人
沙发	恭喜发财
恭喜发财	我 爱 张景硕
我 爱 张景硕	别 惹 我 啊啊啊 啊
还有 智商	你 智商 为 负 啊啊啊
你 智商 为 负 啊啊啊	你 不 爱 我 了 吗
你 不 爱 我 了 吗	很困 别 打扰 我
很困 别 打扰 我	睡 吧
美女 号码 给 一个 啊	我爱柳 涵璐
我爱柳 涵璐	格式 错 了 是 张雨
图一图 二图 三 国航	请问 如何 区分 和 呢
请问 如何 区分 和 呢	看 引擎 或者 机翼 的 非常 大而 和 就是 小 一些 的 引擎
看 引擎 或者 机翼 的 非常 大而 和 就是 小 一些 的 引擎	谢谢 受教 了
孩子 又 闹腾	月 嫂 走 了 没人 看娃 新 找 的 保姆 我 看不上
月 嫂 走 了 没人 看娃 新 找 的 保姆 我 看不上	让 人 再 给 介绍 个 保姆
咋 了 孩子 不好 养	是 呀 没人 帮忙 带 孩子 之前 的 月 嫂到 时间 了 新来 的 不 满意
是 呀 没人 帮忙 带 孩子 之前 的 月 嫂到 时间 了 新来 的 不 满意	让 凯哥 带 去 上班 去
情人节 生 的 恭喜 恭喜	成功 避开 情人节 ' 号 凌晨 点多生 的
成功 避开 情人节 ' 号 凌晨 点多生 的	羡慕
求 推荐 清洁 面膜	哈哈 还是 欣兰冻 膜 好 用 但是 不 耐用
哈哈 还是 欣兰冻 膜 好 用 但是 不 耐用	用 的 快
用 的 快	嗯 我 每次 抹 的 多 因为 那个 要厚涂 估计 次用 完 了
晴天 你 就要 上工 了	我们 今天 还 给钱 呢
我们 今天 还 给钱 呢	快古 几古 几多 求 几天 雨
快古 几古 几多 求 几天 雨	咕 叽咕 叽
不 听 不 听 王八 念经	你 你 快 听
你 你 快 听	你 能 不能 把 原图 私信 发给 我 拜托 拜托
我 不 看 我 不 看 我 不 听 我 不 听	阿西 吧 你 这 头像
阿西 吧 你 这 头像	真是 非常 厉害 啊 是 吧
真是 非常 厉害 啊 是 吧	没错 看着 想入非非
没错 看着 想入非非	图片 评论
是 哪 一瓢 呢	像不像 你
像不像 你	不 我 眼睛 哪有 那么 大
不 我 眼睛 哪有 那么 大	是 啊 的确
好 厉害 我 都 没上	你 申论 强 无敌 是 个 坎 坚持 就 能 迈过去 的 么 么 哒
你 申论 强 无敌 是 个 坎 坚持 就 能 迈过去 的 么 么 哒	可是 还有 几天 就 考试 了
可是 还有 几天 就 考试 了	小 宇宙 爆发 吧 就是 你 了
考省 考 的 么	苏州 的 职位
苏州 的 职位	加油 那 都 不是 事
你 是 大川 吗	阿
阿	是不是
是不是	不是 吧 我 不 知道 你 说 的 是 谁
哈 好巧 生日快乐 小宝贝	是 一样 生日 吗 生日快乐
是 一样 生日 吗 生日快乐	不是 哈一 进来 正好 是 生日
不是 哈一 进来 正好 是 生日	嘻嘻 那 谢谢 你 祝福 啦
双眼皮	要 看 我 浪费 掉 的 双眼皮 贴 吗
要 看 我 浪费 掉 的 双眼皮 贴 吗	熟能生巧 慢慢 练
我 以前 就 知道 拿个 盒子 装 起 这个 人太 没得 技术含量 了	昨晚 忘 了 一件 事 昨天 是
昨晚 忘 了 一件 事 昨天 是	嗯 对 一年
嗯 对 一年	你们 有没有 纪念 一下
你们 有没有 纪念 一下	没有 昨天 在 闹别扭
可是 连 滤镜 都 没加 呢 字 太 好看 啦	再 夸奖 我 我会 膨胀 的
再 夸奖 我 我会 膨胀 的	有 啥 膨胀 就 膨胀 呗 那 我 默默 留着 欣赏
有 啥 膨胀 就 膨胀 呗 那 我 默默 留着 欣赏	哈哈哈 哈哈哈
敲敲 敲敲 敲 可爱	你 在 夸 我 和 鐾 蓓 吗
你 在 夸 我 和 鐾 蓓 吗	当然 啊
千沟万壑 扎心 了	千沟万壑 赴 荆门 我 背对 了 吗
千沟万壑 赴 荆门 我 背对 了 吗	只是 当年 学 地理 的 时候 也 是 一模一样 的 四个 字
只是 当年 学 地理 的 时候 也 是 一模一样 的 四个 字	你 当年 的 地理 老师 是 谁
你 当年 的 地理 老师 是 谁	吴 文成
鉴鉴 晚安 快 删掉 它们 丑到 我 了	哎呀 我 知道 是 我 的 字 丑 到 你 啦 不删 不删 我 厚脸皮
哎呀 我 知道 是 我 的 字 丑 到 你 啦 不删 不删 我 厚脸皮	才 不是 啊 你 的 字 简直 美哭 好 吗 我 被 自己 丑到 了
才 不是 啊 你 的 字 简直 美哭 好 吗 我 被 自己 丑到 了	你 也 敲 可爱 啊
這樣 看 你 黑 了 曬 的	光线 问题 真人 白 的 很
光线 问题 真人 白 的 很	圖片 評論
居然 不是	怎样
怎样	哈哈哈哈 大意 了
我 想 吃屎 应该 不会 有人 看到 吧	真是 一个 有 勇气 有 胆量 的 孩子
真是 一个 有 勇气 有 胆量 的 孩子	这么 快 就 被 发现 了
总 觉得 别人 的 男朋友 好 这 是 什么 病	真特 么 实诚 把 她们 都 绿 了
真特 么 实诚 把 她们 都 绿 了	真想
真想	不 懂 现在 的 年轻人 都 好 开放
不 懂 现在 的 年轻人 都 好 开放	就是 怎么 都 那么 开放
就是 怎么 都 那么 开放	人丑 一个 也 没 碰到 过
人丑 一个 也 没 碰到 过	哈哈 厉害 哦
相对 啪啪 啪 更 喜欢 抱 着 睡 不是 性 的 释放 是 感情 的 寄托	抱 着 不 啪 应该 是 性无能 吧
抱 着 不 啪 应该 是 性无能 吧	不 一定
不 一定	单身 狗 表示 不 小心 碰 一下 美女 都 会 想入非非
如果 哪一天 忘记 了 在 这里 留言 那 说明 那天 我 很 开心 没有 睡 不好 没有 想起 你 没有 没有 你	你 最近 都 没有 想起 她 呦
你 最近 都 没有 想起 她 呦	因为 有 你
因为 有 你	就 知道
就 知道	晚安
我 喜欢 一个 女孩 她 不 喜欢 我 怎么办	找 机会 强吻 她 不要 怂 就是 上 扇 一巴掌 又 怎样 不 搭理 又 怎样 反正 比 现在 差 不了 哪
找 机会 强吻 她 不要 怂 就是 上 扇 一巴掌 又 怎样 不 搭理 又 怎样 反正 比 现在 差 不了 哪	吓 尿 了 我 看成 强奸 她 了
吓 尿 了 我 看成 强奸 她 了	强奸 她 就 吓 尿 了 你 确定 是 尿
哈哈哈 刘全 有 微博 那个	没看 他 微博 卧槽 尴尬 了
没看 他 微博 卧槽 尴尬 了	哈哈哈 好 吧 好 吧
哈哈哈 哈哈	你 好看 你 可以 笑
你 好看 你 可以 笑	不 不 不 第一 感觉 像 个 笑话
不 不 不 第一 感觉 像 个 笑话	就是 笑话
迎春 出 的 新品 但是 有点 甜 有点 腻	哪家
哪家	迎春
南昌 这场 我 在 第六 排	我 在 第九 排
我 在 第九 排	哈哈哈哈 感觉 每次 看 演唱会 都 能 碰见 奇怪 的 人 这场 我 前面 坐 的 那个 女孩子 居然 当场 百度 百科 陈奕迅
哈哈哈哈 感觉 每次 看 演唱会 都 能 碰见 奇怪 的 人 这场 我 前面 坐 的 那个 女孩子 居然 当场 百度 百科 陈奕迅	我 旁边 的 也 是 全程 玩 手机 还 问 我 怎么 你 迅不 说话 的 后面 应该 感觉 是 无聊 了 就 走 了 还有 下雨 的 时候 很多 人 离场 诶
我 旁边 的 也 是 全程 玩 手机 还 问 我 怎么 你 迅不 说话 的 后面 应该 感觉 是 无聊 了 就 走 了 还有 下雨 的 时候 很多 人 离场 诶	是 哟 太多人 走 了 然后 安可 的 时候 全乱 了 管不了 了 于是 我 就 挤 到 最 前面 栏杆 那去 了
是 哟 太多人 走 了 然后 安可 的 时候 全乱 了 管不了 了 于是 我 就 挤 到 最 前面 栏杆 那去 了	哈哈哈 安可 的 时候 我 拼命 往前 挤 在 四排 满足 了
同问	你 看 评论 有毒
你 看 评论 有毒	哎
我 最近 要 睡 死 过去 了	我 最近 没法 睡觉
我 最近 没法 睡觉	喝牛奶
喝牛奶	没用 啊 睡眠 很 浅 最 多 睡 一两个 小时 醒 了 之后 睁眼 到 天亮
同 失眠	没 办法 了 根本 不能 睡
没 办法 了 根本 不能 睡	困 也 睡不着
困 也 睡不着	听 了 一 晚上 歌
听 了 一 晚上 歌	我 还 看 诗 了 呢
哈哈网 红顺 的 日常	别 小姐姐 才 是 网红 我 只是 做 了 个 凡夫俗子 做 的 事 而已
别 小姐姐 才 是 网红 我 只是 做 了 个 凡夫俗子 做 的 事 而已	现在 说话 一套 一套 的
现在 说话 一套 一套 的	那 请问 套住 你 了 么
那 请问 套住 你 了 么	哈哈哈 很 有 长进
哈哈哈 很 有 长进	承 让 了
你 还 记得 她 么	请问 你 说 的 是 我领 居家 的 那条 母狗 吗
请问 你 说 的 是 我领 居家 的 那条 母狗 吗	哈哈哈 是
哈哈哈 是	那 我 当然 还 记得
恕我直言 算了 不 说 了	别别 别 你 直接 当面 说好 了
别别 别 你 直接 当面 说好 了	不 你 还是 个 孩子
不 你 还是 个 孩子	别 你 这样 友尽 好 了
别 你 这样 友尽 好 了	那好 吧 我 无 说
那好 吧 我 无 说	别别 别 你 还是 有话直说 的 好
哪个 区	艾欧 尼亚
艾欧 尼亚	好 一起 等 一会儿
不要脸 喊 你 干嘛 来 着	怎么 了
怎么 了	关注 什么 结果 全去 演唱会 了
关注 什么 结果 全去 演唱会 了	演唱会 和 其他 有 啥 关系
哈哈哈哈 五月天 嗨 爆	我 是 假 粉丝 哈哈哈 那个 歌单 只有 一半 听 过去 感受 现场 气氛
我 是 假 粉丝 哈哈哈 那个 歌单 只有 一半 听 过去 感受 现场 气氛	嘻嘻 瞎 唱 没人 你 的
嘻嘻 我 五月天 济南 今天 也 到 了	哇 你 为啥 去 济南
哇 你 为啥 去 济南	是 离 我 比较 近 的 一个 城市 啦
是 离 我 比较 近 的 一个 城市 啦	好 的 吧
一个个 都 去 踏春 晒 暖 了 贼 羡慕	哈哈 满 朋友圈 的 春游
哈哈 满 朋友圈 的 春游	图片 评论
果然 开口笑 好看	买 吧 买 吧
买 吧 买 吧	我 有 嘻嘻
吃 吃 吃	脸 可以 说 是 非常 肥 了
脸 可以 说 是 非常 肥 了	不怕 我 的 更 肥
不怕 我 的 更 肥	抱紧 你
说 出来 你 可能 不 信 最后 一秒 进 的 教室	刚 坐下 吃 早饭 的 我
刚 坐下 吃 早饭 的 我	图片 评论
图片 评论	图片 评论
图片 评论	表情 包太萌
表情 包太萌	我 女朋友
我 女朋友	打死 你 个 臭 不要脸 的
花 了 秒钟 说服 说服 自己 不要 为了 考研 而累 着 所以 就 别考 了	哈哈哈 可 不能 苦 了 自己
哈哈哈 可 不能 苦 了 自己	就 应该 嗨 皮 嗨 皮
就 应该 嗨 皮 嗨 皮	人生 苦短
人生 苦短	及时行乐
你 走 了 哦	是 啊 到 家 了
是 啊 到 家 了	辣 么 快 在 哪 啊
辣 么 快 在 哪 啊	天津
在 万达	对 是 万达
对 是 万达	约 吗 万达
约 吗 万达	这里 是 石家庄
这里 是 石家庄	我 五一 回去
咋 了 坏 了 一个	另一只 太 魅惑
另一只 太 魅惑	信 了 你 的 邪
树欲静	都 會 搶答 了
都 會 搶答 了	告诉 你 个 消息 下周 又 要 去 杭州 了
不要 长大	永远 年轻
永远 年轻	是 的 没错
我 一直 以为 你 是 女生	互关 这么久 你 不 可能 没 看过 我 微博 阿 .
互关 这么久 你 不 可能 没 看过 我 微博 阿 .	我 的 错
喜欢 你 这个 墨镜 哪儿 买 的	实体店 哈
实体店 哈	什么 牌子 我 也 去 买个
可以 的	我 开始 准备 来 石家庄 的
我 开始 准备 来 石家庄 的	哈哈哈 来 了 招待 你 呀
哈哈哈 来 了 招待 你 呀	哈哈哈 有 朋友 在 石家庄 上学 我 想着 去 保定 那个 白洋淀 所以 准备 先到 石家庄 玩 但是 最后 还是 改了 行程
哈哈哈 有 朋友 在 石家庄 上学 我 想着 去 保定 那个 白洋淀 所以 准备 先到 石家庄 玩 但是 最后 还是 改了 行程	哈哈哈 白洋淀 以后 要 被 发展 了
小帅 锅	你 最帅
你 最帅	有 眼光
头发 长长 啦	哈哈哈 我要 留 丸子 头
哈哈哈 我要 留 丸子 头	刚刚 我 还 反映 了 反应 第一 想法 是 蘑菇 后来 想 丸子 哈哈哈哈 你 可以 的
刚刚 我 还 反映 了 反应 第一 想法 是 蘑菇 后来 想 丸子 哈哈哈哈 你 可以 的	现在 又 可以 扎 小辫子 了 丸子 应该 快 了 过渡期 是 最 尴尬 的
现在 又 可以 扎 小辫子 了 丸子 应该 快 了 过渡期 是 最 尴尬 的	可以 的 你
行星 啊	可 我 想念 冥王 你 呢
可 我 想念 冥王 你 呢	水星 吧 水星 没有 卫星
总算 出现 了 你	想 我 了
想 我 了	太久 没有 看见 你
我 想 问 一下 就是 怎么 不 摁 着 就 可以 一直 录	有 倒计时 哦
有 倒计时 哦	谢谢 啦 啦 啦 啦
無視	这 他 妈 就是 个然 真他妈 还 不是 一点 然
这 他 妈 就是 个然 真他妈 还 不是 一点 然	大概 漿糊 吃 多 了 吧
大概 漿糊 吃 多 了 吧	我 看 是 吃屎 长大 的
我 看 是 吃屎 长大 的	好 吧 別 跟 這人 一般 見識 讓 繼續 吃屎 去
好 吧 別 跟 這人 一般 見識 讓 繼續 吃屎 去	嗯
咋啦 亲	生病 了
生病 了	能 吃饭
好 美的 桃花	人 呢
人 呢	没有 人
秒 懂	什么
什么	你 猜
哈哈 还有 自己 给 自己 评论 的	哈哈 这样
哈哈 这样	你 过来 看 我 不 打 你
你 过来 看 我 不 打 你	哈哈哈 我 不 去
哈哈哈 我 不 去	那 我 来
你养 的 萨摩耶 吗	恩 家里人 养 的
恩 家里人 养 的	就是 特爱 黏人
就是 特爱 黏人	你 也 养 了
你 也 养 了	养 了 一年 多 自己 给 跑 丢 了
养 了 一年 多 自己 给 跑 丢 了	萨摩耶 就是 毛太长 不好 打理 不过 说真的 挺 可爱 的 适合 女性 养
萨摩耶 就是 毛太长 不好 打理 不过 说真的 挺 可爱 的 适合 女性 养	除了 漂亮 一无是处
祝 你 早日 走出 低谷 向 高潮 过渡	跑步走
跑步走	下午 可以 不 这会 下雨 呢
下午 可以 不 这会 下雨 呢	下午 下大 了 呢
下午 下大 了 呢	反正 我 现在 是 不 去 跑 因为 我刚 从 外面 回来
乾县 乡党	是 的
是 的	我为 乾州 人建 了 一个 乾州 老乡 微博 互助 群 你 可 愿意 加入 如愿 我 拉 你
好 不醉 不 归	还有 我
还有 我	家里 是不是 下雪 了
我 最 期待 的 是 兰亭序 的 出世	据说 兰亭集序 好像 在 乾陵 地下 之前 我 老师 讲 历史 也 推断 过 李治 这人 比较 喜好 王羲之 得 作品
据说 兰亭集序 好像 在 乾陵 地下 之前 我 老师 讲 历史 也 推断 过 李治 这人 比较 喜好 王羲之 得 作品	武则天 也 喜欢 二王
武则天 也 喜欢 二王	嗯 嗯
据说 兰亭 正本 就 在 乾陵 下次 我 也 要 去逛	热烈欢迎 多多 宣传 乾陵
热烈欢迎 多多 宣传 乾陵	找 你 喝酒
找 你 喝酒	走路 去
走路 去	你 厉害
你 也 去 泾阳 了	我 就 在 泾阳 原点 家具城 卖 家具
我 就 在 泾阳 原点 家具城 卖 家具	昨天 我 去 那边 路过 你们 门口
昨天 我 去 那边 路过 你们 门口	那 你 不 进来 坐坐
首先 为 你 这种 行为 伸张正义 村 领导 承揽 工程 谋私利 这 只能 说 是 小巫见大巫 了 有 的 村 领导 打着 为 村民 某 利益 侵占 村 集体土地 办 实业 赚 了 几个 亿 了 也 没见 纪委 来 查处	实话
实话	开 金泰 灯城开 古玩城 不仅 是 实业家 还是 政协 委他 也 是 开发商 的 股东 村民 告 了 多次 都 没 告倒 他 上边 有来查 他 会 说 为 村民 创造 了 多少 就业机会
开 金泰 灯城开 古玩城 不仅 是 实业家 还是 政协 委他 也 是 开发商 的 股东 村民 告 了 多次 都 没 告倒 他 上边 有来查 他 会 说 为 村民 创造 了 多少 就业机会	我朝 代表 的 阶级 慢慢 在 发生变化 这种 事情 屡见不鲜 听说 盗 我们 这 盗墓贼 坐 了 几年 牢 出来 后 卖 了 文物 建设 当地 都 当 政协委员 了
我朝 代表 的 阶级 慢慢 在 发生变化 这种 事情 屡见不鲜 听说 盗 我们 这 盗墓贼 坐 了 几年 牢 出来 后 卖 了 文物 建设 当地 都 当 政协委员 了	盗墓贼 成为 文物 专家 的 也 不少 说起 村 领导 想 谋利 也 不少 有 的 能 使村 集体 越壮 越大 陈砦 村 搞 养植 种植 的 花卉市场 花卉 成为 了 陈砦 的 朝阳产业 越 搞 越 大 成为 了 全国 远近闻名 大型 花卉 批发 集散地 可以 在线 观看 一下 陈砦 花卉 谋利 不怕 关键 看 能否 实现 正义 转型
盗墓贼 成为 文物 专家 的 也 不少 说起 村 领导 想 谋利 也 不少 有 的 能 使村 集体 越壮 越大 陈砦 村 搞 养植 种植 的 花卉市场 花卉 成为 了 陈砦 的 朝阳产业 越 搞 越 大 成为 了 全国 远近闻名 大型 花卉 批发 集散地 可以 在线 观看 一下 陈砦 花卉 谋利 不怕 关键 看 能否 实现 正义 转型	我们 咸阳 礼泉 袁 家村 也 不错 乡村 旅游 一年 十个 亿
我们 咸阳 礼泉 袁 家村 也 不错 乡村 旅游 一年 十个 亿	听说 过 旅游 产业 其实 从 过往 岁月 当中 的 城中村 租房 生意 全村 收入 也 能 达到 多少 个 亿说 到 旅游 产业 有过 想法 想到 第二 故乡 规划 线路 寻找机会 但是 古村落 受到 了 产业 聚集区 冲击 和 变革 现只 剩下 了 曹 刘庄 还 保存 着 历史 原貌 这里 有 曹 叡 墓 娘娘 山广成 关妙 水寺 皇家 猎场 和 温泉 等 旅游 资源
听说 过 旅游 产业 其实 从 过往 岁月 当中 的 城中村 租房 生意 全村 收入 也 能 达到 多少 个 亿说 到 旅游 产业 有过 想法 想到 第二 故乡 规划 线路 寻找机会 但是 古村落 受到 了 产业 聚集区 冲击 和 变革 现只 剩下 了 曹 刘庄 还 保存 着 历史 原貌 这里 有 曹 叡 墓 娘娘 山广成 关妙 水寺 皇家 猎场 和 温泉 等 旅游 资源	乡村 旅游 的 同质化 太 严重 了 没有 突出 的 特色 千篇一律
乡村 旅游 的 同质化 太 严重 了 没有 突出 的 特色 千篇一律	豫西 民居 是 很 有 特色 的
成都 天气 好 吗	跟 在 西安 似的 天 一直 都 可 阴 了
跟 在 西安 似的 天 一直 都 可 阴 了	又 是 重度 污染
貌似 遭 你 同学 吐槽 了	那 是 我 哥们 我 也 天天 吐槽 他
那 是 我 哥们 我 也 天天 吐槽 他	我 知道
又 开始 秀	好好 的 下个月 会 西安 请 我 吃饭
好好 的 下个月 会 西安 请 我 吃饭	特产 带上
特产 带上	没 问题 紫菜 海带 猪蹄 随便 吃
没 问题 紫菜 海带 猪蹄 随便 吃	这算 吗
这算 吗	这 可是 宁德 特产 啊
这 可是 宁德 特产 啊	那 就 多 带点
有点 美	给 你 找 点儿 灵感
给 你 找 点儿 灵感	相机 都 落 灰 了
相机 都 落 灰 了	鸟悄儿 地 拿 出来 擦擦
鸟悄儿 地 拿 出来 擦擦	先 擦擦 眼泪 吧
可爱	第一张 超可耐
第一张 超可耐	感觉 自己 萌萌 哒
不许 爱上 黄忠	爱上 色情 墨子
爱上 色情 墨子	哈哈哈
咦 你 咋 又 回去 了 呢	看 外公 吃 大餐
看 外公 吃 大餐	棒 回国 好好 耍 一下
棒 回国 好好 耍 一下	安逸 得板
叫 我 何事	你 是 爸爸 还是 仙女
你 是 爸爸 还是 仙女	我 下凡 不是 给 你 当 爸爸
早上 六点半 起床 上班时间 很 痛苦 的 事情 你 有 时间 再来 咯	请众 筹 我 的 车票 钱
请众 筹 我 的 车票 钱	来来来 打个 麻将 吧 说不定 住宿费 也 能 赢 出来
你 长得 挺 像 爷们 的 尤其 那张 稍微 有点 长 的 脸	大胖 脸 给 我 好好 说话 要 不 就 祝你幸福 了
大胖 脸 给 我 好好 说话 要 不 就 祝你幸福 了	大爷 你 收留 我 吧 你 脸长 我 也 不 嫌弃 好不好
大爷 你 收留 我 吧 你 脸长 我 也 不 嫌弃 好不好	带 我 吃 牛肉 火锅 去 然后 我 就 不 嫌弃 你 脸大 了
带 我 吃 牛肉 火锅 去 然后 我 就 不 嫌弃 你 脸大 了	我 明天 去 新 东方学 个 厨子 吧 好不好
我 明天 去 新 东方学 个 厨子 吧 好不好	诶 呀 突然 好 喜欢 你 啊
哈哈哈 之前 有个 教授 特意 跳出 来说 棱应 是 陵 还 被 网友 骂 的 上 热 搜 了 哎呀呀 哈哈哈	我 背着 写 的 果然 写错 了 还有 我要 吃 小木屋
我 背着 写 的 果然 写错 了 还有 我要 吃 小木屋	哈哈哈 一点 痕迹 都 木有 这 周末 安阳 来到 时候 给 你 发图片 哈
然后 你 就 靠 小哥 养好 了 不 需要 上班	嗯 我 跟 他 商量 过 把 他 卖 给 富婆
嗯 我 跟 他 商量 过 把 他 卖 给 富婆	那 我 觉得 应该 还是 他 自己 挣钱 比较 快卖 富婆 有人 要 咩 卖 不 上价 吧
那 我 觉得 应该 还是 他 自己 挣钱 比较 快卖 富婆 有人 要 咩 卖 不 上价 吧	我会 如实 转告 他 的
因为 你 只有 一个 手机	哈哈哈
哈哈哈	那 啥 你 值得 拥有 不要 不要 只要 啥 来 着 哦 只要 你 有 核桃 你 有 坚果 你 可以 用来 敲 了 吃
那 啥 你 值得 拥有 不要 不要 只要 啥 来 着 哦 只要 你 有 核桃 你 有 坚果 你 可以 用来 敲 了 吃	逗比
逗比	对 那 啥 就是 你 说 的 这个 为 你 的 机智 点赞 真挚 的 面容 加上 适时 的 拍照 等于 最美 不是 为了 拍照 而 拍照 而是 为了 记录 心情 而 拍照
对 那 啥 就是 你 说 的 这个 为 你 的 机智 点赞 真挚 的 面容 加上 适时 的 拍照 等于 最美 不是 为了 拍照 而 拍照 而是 为了 记录 心情 而 拍照	拍 的 是 心情
拍 的 是 心情	咋 感觉 我 在 说 真话 哎 我 不是 有意 要 赞美 你 我 只是 在 假装 说实话
咋 感觉 我 在 说 真话 哎 我 不是 有意 要 赞美 你 我 只是 在 假装 说实话	还 配合 你 演出 的 我 却 视而不见
我 也 要 坐 宝马	赶紧 去 买 一个
赶紧 去 买 一个	我 只 想 坐 你家 有 我 坐 哈 就 可以 了
我 只 想 坐 你家 有 我 坐 哈 就 可以 了	我家 的 是 路
下次 带上 我	去 杭州 帮老卢 叫 上
去 杭州 帮老卢 叫 上	好 的 啦
想 找 你 拍照	我们 下次 一起 约 他
我们 下次 一起 约 他	好 等 他 放假 或者 什么 时候 一波 人 去 武汉 吧
我 属 虎	我 也 是
我 也 是	好巧 哦
好巧 哦	碰巧
我 猜 你 是 学 法学 的	嘻嘻 不 对
嘻嘻 不 对	真 爱 生命 远离 法学
真 爱 生命 远离 法学	这么 说 我 走上 了 自杀 的 道路
这么 说 我 走上 了 自杀 的 道路	要考 司法考试 的话 一定 是 要 消耗 大量 的 精力 的 呢
要考 司法考试 的话 一定 是 要 消耗 大量 的 精力 的 呢	不是
是 这样 通俗 的 解释 下 我 也 刚 入门 是 侮辱 尸体 罪 因为 犯罪人 主观 认为 她 强奸 的 尸体 他 没有 预见 她 是 活人 所以 最 可能 是 疏忽大意 的 过失 或 意外事件 意外事件 不 定罪 疏忽大意 的 过失 解释 不通 哪有 不 小心 强奸 人 的 没有 过失 强奸罪 虽说 侮辱 尸体 罪轻 便宜 这 男人 了 但 的确 是	儿 砸 你好 腻害
儿 砸 你好 腻害	嘻嘻 爸爸 最近 在 学
嘻嘻 爸爸 最近 在 学	学 你 要 干 啥
我 英语 不行 所以 不考	还 来得及
还 来得及	考公
专业 摄影师	其实 这个 你 比较 专业
其实 这个 你 比较 专业	我 的 姿势 肯定 更帅
我 的 姿势 肯定 更帅	你 有 个 很酷 的 爸爸 我
你 有 个 很酷 的 爸爸 我	儿子 又 调皮 了
儿子 又 调皮 了	儿 砸
儿 砸	儿 砸 不听话
舍花 是 谁 介绍 一下	除了 我 都 名花有主
除了 我 都 名花有主	那么 问题 来 了 为什么 啊
那么 问题 来 了 为什么 啊	现在 女朋友 不好 找
世界 只有 一个 花 强行 笔芯	这句 说 我 读 了 好几遍
这句 说 我 读 了 好几遍	就是 要 你 记 心里
就是 要 你 记 心里	笔芯
对 的 嘛 吃酒 吃 不醉 就 白吃 了	这句 话 , 我 喜欢 说 !
这句 话 , 我 喜欢 说 !	说 的 对 撒 哈哈哈
谢谢 你	谢谢 我 干嘛
谢谢 我 干嘛	要 我 好好 的 享受 生活 啊 我 过 的 太 憋屈 了 , 从此以后 我 不 在 为 婚姻 而活 他 不 珍惜 我 是 他 的 损失
要 我 好好 的 享受 生活 啊 我 过 的 太 憋屈 了 , 从此以后 我 不 在 为 婚姻 而活 他 不 珍惜 我 是 他 的 损失	嗯 嗯 从头再来
你 是 军人 吗 最 崇拜 的 就是 军人 了 很 高兴 认识 你	曾经 是 吧
曾经 是 吧	那 也 很 让 人 崇拜
你 咋啦 这么 多愁善感 了	没事
没事	是 么 有事 要说 出来 哈
不错 给 你 一百个 赞	快 给
快 给	好 的
我 也 这么 认为	嗯 嗯 真理 啊
嗯 嗯 真理 啊	夸 我 咯
夸 我 咯	真不错
同样 的 苦闷 经常 要 删 一下	哈哈
哈哈	时常 在 想 可不可以 集齐 一百个 卖片 的 换 一个 大 的 关注
时常 在 想 可不可以 集齐 一百个 卖片 的 换 一个 大 的 关注	别想 了 不 可能
别想 了 不 可能	但 这 是 我 在 黑暗 的 心情 下 做 的 最 艳丽 的 梦
但 这 是 我 在 黑暗 的 心情 下 做 的 最 艳丽 的 梦	这个 梦 以后 也 别 做 了 是 恶梦
这个 梦 以后 也 别 做 了 是 恶梦	想 怼 死 这帮 卖片 的
爱 只会 加深 根本 不会 变淡 只是 受伤 大 了 一时 的 自欺欺人 所以 尽量 不要 刺激 对方 呀	离开 的 人 是 自欺欺人 吗 不会 回来 了 吧
离开 的 人 是 自欺欺人 吗 不会 回来 了 吧	人 和 人 不同 吧 离开 的 人 不配 说 爱 吧
这 里面 没有 猪头 表情 吗	你 上次 微博 就是 为了 发 这个 表情 对 吧
你 上次 微博 就是 为了 发 这个 表情 对 吧	不是 这 里面 的 表情 哈哈
不是 这 里面 的 表情 哈哈	走
这	好假
好假	不假 就 怪 了
总是 带个 小 文艺 范的 句子	天生 文艺 范
天生 文艺 范	天生 张小二
你们 背到 我 干 了 撒子	这个 汪 不是 那个 汪
这个 汪 不是 那个 汪	我 晓得 你 的 大学 同学 的 嘛
这是 哪里 呀	联勤 啊
联勤 啊	现在 的 样子 吗
小小年纪 不 学好 染发	八格 牙路
八格 牙路	呀 咩 蝶
第二张 站 着 的 最 左边 是 谁 啊	我 也 忘 了 不是 咱们 这 的
我 也 忘 了 不是 咱们 这 的	原来 是 他 啊 确实 有点像 他 好像 不是 我们 这 的 吧
原来 是 他 啊 确实 有点像 他 好像 不是 我们 这 的 吧	庙子 那边 的
什么 手机 ?	美 图 专治 丑症
美 图 专治 丑症	哈哈哈 好 吧
来 张自 拍 效果图 看看	丑到 美图 都 救 不了 我
丑到 美图 都 救 不了 我	来 我 帮 你
我官 网上 没 抢 到 就 在 淘宝 买 了	官网 跟 淘宝 差别 大不大
官网 跟 淘宝 差别 大不大	只有 价格 差别
只有 价格 差别	真惨 摸摸头
其实 一点 都 不 高尚	大半夜 不 睡觉 要 修仙 吗
大半夜 不 睡觉 要 修仙 吗	凄冷 长夜 无心 睡眠 如 遗世独立 羽化 而 登仙
有没有 变美签 给 我 来 一支	变美签 我 抽走 了 你 变丑 吧
变美签 我 抽走 了 你 变丑 吧	口亨 就 不能 有 两个 变美签
口亨 就 不能 有 两个 变美签	不能 给 自己 树敌
你学 的 啥 周周	这是 我们 组织 里 去 高中 做 教官 和 我 的 专业 没关系
这是 我们 组织 里 去 高中 做 教官 和 我 的 专业 没关系	哦 哦 哈哈 酷
香蕉 控爱上 了 仙贝 反正 都 不是 我 爱 吃 的	你 不 懂 我 我 不怪 你 我 爱 吃 橘子 仙贝 物语 真的 好吃 浓浓 爱情 滋味
你 不 懂 我 我 不怪 你 我 爱 吃 橘子 仙贝 物语 真的 好吃 浓浓 爱情 滋味	爱情 的 味道 波力 海苔
爱情 的 味道 波力 海苔	是 时候 见 一面
哈哈哈 哈哈 榜 婊	榜 婊
榜 婊	删 我次
有点 志气 好 吗 胖 怎么 了 还 能 胖 一辈子 吗 还 别说 真 可能 胖 一辈子	你 看 你 微信 还 能 跟 我 说话 吗
你 看 你 微信 还 能 跟 我 说话 吗	能 说 咋 了
结果 没吓 成反 被 节食 倒打一耙	嘻嘻 你 懂 我
嘻嘻 你 懂 我	哈哈哈哈 我 就是 这样
加油 相信 自己 你 是 最 胖 的	很棒 我 是 最 胖 的
很棒 我 是 最 胖 的	啊 哈哈 其实 健康 最 重要 啦
别 减肥 我 都 减 感冒 啦	注意 身体 啊 别 太 节食
注意 身体 啊 别 太 节食	就 坚持 了 天
我 在 最右 看到 了 你 的 头像	最右
最右	就是 最右
就是 最右	哪里 的 最右
哪里 的 最右	最右 是 个 啊
因为 要 自己 看太美 了 对 着 镜子 能 看 一天 出水芙蓉 等 下 我 先 去 把 鼻血 止住	比 我 脸皮 还厚
比 我 脸皮 还厚	谢谢
考研 复试 成功	等 你 好消息
等 你 好消息	谢谢
四六级 入编 升本愿 所愿 的 都 能 实现	嗯 前 两个 我 已经 实现 了
嗯 前 两个 我 已经 实现 了	我 很快 就要 去 实现 第一个 了
滴 不尽 相思 血泪 抛 红豆 开不完 春柳 春花 满 画楼 从小到大 心心念念 的 都 是 当 军嫂	哈哈 向 未来 的 军嫂 致敬
哈哈 向 未来 的 军嫂 致敬	借 你 吉言
不 抛弃 不 放弃	士兵 突击
士兵 突击	加油 吧 为 理想 努力
四月 啊 心愿 是 顺利 把 自己 上 交给 国家	你 也 有 这样 的 愿望
你 也 有 这样 的 愿望	对 啊 想 了 很久很久 了 希望 今年 一切顺利
对 啊 想 了 很久很久 了 希望 今年 一切顺利	女兵 的 路 更加 艰辛 啊 不管 怎么样 祝福
女兵 的 路 更加 艰辛 啊 不管 怎么样 祝福	唉 都 加油 加油 努力 一把
每周 考 的 打击 算 什么 为 六月 打天下 才 是 真为 梦想 加油 老铁	势不可挡 逐梦 六月
势不可挡 逐梦 六月	坚持 是 王道 必须 滴
太 多 目前 是 要 写 论文 写 论文 写 论文 可是 题目 还 没定 好	哈哈 这是 一条 任重而道远 的 路
哈哈 这是 一条 任重而道远 的 路	说 多 了 都 是 泪
加油 老铁	嗯 我 以为 你 失踪 了
嗯 我 以为 你 失踪 了	最近 比较忙
最近 比较忙	忙 是 好事 年轻 就要 折腾
忙 是 好事 年轻 就要 折腾	是 啊 为了 以后 想要 的 胜过
哈哈哈	时间 都 还 未 到 愚人节 你 就 先愚 快 了
时间 都 还 未 到 愚人节 你 就 先愚 快 了	提前 了
晚安 了	早安 啊
早安 啊	早
鼓起勇气 向前 冲	迎着 冷眼 和 嘲笑
迎着 冷眼 和 嘲笑	加油 加油 加油
我 想 摸摸 你 的 小狗狗	哈哈 问问 它 愿不愿意
哈哈 问问 它 愿不愿意	啊啊啊 啊 啊 啊啊啊 他 好萌 超级 想 抱抱 他 替 我 问问 他 行不行
两三点 睡觉 七点 起床 表示 熬夜 真是 病	没事 多 看看 熬夜 的 坏处 你 会 发现 熬夜 真的 不算什么 哈哈哈 开玩笑 以后 早 睡觉
没事 多 看看 熬夜 的 坏处 你 会 发现 熬夜 真的 不算什么 哈哈哈 开玩笑 以后 早 睡觉	心塞
喜欢 男生	你好 我 叫 男生
你好 我 叫 男生	那 我 摔 咯
胸小 穿衣服 好看	我 无力 反驳
我 无力 反驳	比如 我
比如 我	这个 我 看 出来 了
自己 摸大	可以 你 是 个 男 的
可以 你 是 个 男 的	我 的 意思 你 应该 明白
真 美 哈哈哈	明天 下午 一起 去 爬山
明天 下午 一起 去 爬山	好 的 好 的
美 啊	很多很多 很多很多 很多很多 很多 很多很多 很多很多 很多很多 真的 超级 多
很多很多 很多很多 很多很多 很多 很多很多 很多很多 很多很多 真的 超级 多	是不是 把 你 都 挤 瘦 了
是不是 把 你 都 挤 瘦 了	哈哈哈哈 幸亏 我 瘦 才能 在 人群 中 穿梭
哈哈哈哈 幸亏 我 瘦 才能 在 人群 中 穿梭	哈哈 可以
你 怎么 这么 漂亮	照片 骗骗 人 的
照片 骗骗 人 的	真的 漂亮
真的 漂亮	第五第六 张 都 不 一样
这 大爷 球技 好 溜 你们 可以 留下 喜欢 的 歌曲 电影 喜欢 的 人 的 名字 兴趣爱好 什么 的 把 这里 当 树洞 什么 都 可以 留 反正 也 没人 看见	这个 是 他 化妆 了 其实 是 职业 球员 的 那种
这个 是 他 化妆 了 其实 是 职业 球员 的 那种	欧文
我恺	郑恺
郑恺	是 是 是
我 搬 凳子 看 评论	出售 瓜子 饮料 吗
出售 瓜子 饮料 吗	免费 的 有 吗
免费 的 有 吗	看 你 长得 可爱 价格 翻倍 好 了
看 你 长得 可爱 价格 翻倍 好 了	滚
老 司机 又 飙车 了 真是 一代 污王	过誉 了
过誉 了	往往 躲 在 屏幕 后 的 污 现实 中 应该 是 个 乖乖女 比如 我
进去 吐口 痰	我 看 了 三遍 才 看 懂
我 看 了 三遍 才 看 懂	哈哈哈
哈哈哈	图片 评论
图片 评论	你 做梦
我 就 在 门口 蹭 蹭 保证 不 进去	你 要 进去 就是 这 下场
你 要 进去 就是 这 下场	图片 评论
图片 评论	图片 评论
我 就 进去 一下	不要 你 蹭 蹭
不要 你 蹭 蹭	怼 两下
怼 两下	别停 啊
别停 啊	叫 老公 不 叫 不 给 射
叫 老公 不 叫 不 给 射	那 就 别射 再 呆 一会
我 也 保证 不动 就 揉 揉 你	你 也 要 有 机会 啊
你 也 要 有 机会 啊	机会 在 哪里 快给我
不 大家 都 在 思春	你 也 是 吗
你 也 是 吗	必须
必须	可 我 在 想 你
可 我 在 想 你	撩 我 讨厌
啵 啵 宝宝	看 我 微博 就 知道 了 去 没 去 累死 了 我 都
看 我 微博 就 知道 了 去 没 去 累死 了 我 都	你 连续 两天 了
对伐	真 好
真 好	天气 这么 好多 出去 走走
人品 够 好 了 你 就是 能 在 污 一点 就 心满意足 了	不 不 不 适可而止
不 不 不 适可而止	反正 你 已 走 在 污 的 路上 了 干脆 登顶 成为 巫妖王
喜欢 香菜 杆儿	超级 喜欢
超级 喜欢	无 香菜 不欢 一族
无 香菜 不欢 一族	没 毛病
质量 这么 好 的 碗 请 给 我 来 一打	哈哈哈哈 好
哈哈哈哈 好	可以 选 颜色 吗 到 付
可以 选 颜色 吗 到 付	想 的 美
你 踏马 咋 这么 爱 香菜	哈哈哈 超级 喜欢
哈哈哈 超级 喜欢	你 俩 挺 适合 一起 种 香菜 去 吧
你 俩 挺 适合 一起 种 香菜 去 吧	拒绝
我 也 喜欢	那 你 多 吃 点
那 你 多 吃 点	买 给 我 啊
买 给 我 啊	我 给 你 买 块 地 你 自己 种 把
多 贤惠 的 妹子 啊 碗 不 就 磕 了 几个 口子 嘛 大惊小怪	对 对 对
对 对 对	那么 说 的 都 是 城里人 你 问问 清朝 的 碗 能 卖 多少 卖 给 他们 咱 就 发 了
雪明 老师 好 棒棒 频频 岀 书	谢谢 朋友 鼓励 支持
谢谢 朋友 鼓励 支持	老师 客气 了
看望 老师 祝 快乐	朋友 再见
朋友 再见	欢迎 老师 祝 快乐
老师 书我买 到 了 今天 拿 回来 了 好开心 啊 要是 有 签名 就 更好 啦 嘿嘿 我 一定 好好 读一读 呢	在 哪 买 的
在 哪 买 的	我 打 了 您 给 的 电话 然后 说 让 我 在 当当网 上 买 就 可以
你好 求看 我 置顶 微博 关于 深圳 无良 奸商 的 事情 求 转发 求 声援 谢谢	你 可以 求助 第一 现场
你 可以 求助 第一 现场	找 了 第一 现场 呢 也 播出 了 商家 仍然 不 道歉 不 声明 态度恶劣 谢谢 老师
找 了 第一 现场 呢 也 播出 了 商家 仍然 不 道歉 不 声明 态度恶劣 谢谢 老师	可以 找 律师 聊聊
拿走 好 嘛	拿走 可能 会 被 打死
拿走 可能 会 被 打死	带怕 了
好 漂亮 啊 小姐姐	哈哈 我 不是 你 的 小姐姐
哈哈 我 不是 你 的 小姐姐	那 你 是 我 的 什么 优 乐美
那 你 是 我 的 什么 优 乐美	捧 在 手心 还是 丢进 垃圾桶
捧 在 手心 还是 丢进 垃圾桶	手心 啊
手心 啊	那 就是 优 乐美 咯
那 就是 优 乐美 咯	小姐姐 真乖
早安 这 几天 过得 怎么样	好 想 满怀 心事
好 想 满怀 心事	满怀 心 事先 放松 几天 吧 放松 下 自己
你 像 我 的 人	认真 醉过
认真 醉过	认真
没 毛病	还 不 都 是 穷
还 不 都 是 穷	西湖 又 不要 钱
西湖 又 不要 钱	作为 一个 浙江人 表示 西湖 没 啥 好看 的
作为 一个 浙江人 表示 西湖 没 啥 好看 的	龙翔桥 那里 有 一家 路 易威登
龙翔桥 那里 有 一家 路 易威登	关 我 屁事
关 我 屁事	西湖 的 这家 店 好玩 啊
橘猫	是 哒 卡哇伊
是 哒 卡哇伊	约 猫 约 猫
约 猫 约 猫	我 同学 的 房子 可以 带 着 猫咪 一 起来 玩
我 同学 的 房子 可以 带 着 猫咪 一 起来 玩	好 嘞
王留龙 在 这 呢	他 单位 在 这儿
他 单位 在 这儿	对 啊 在 水库 那边
对 啊 在 水库 那边	雁栖湖 旁边 的 水库 吗 这 环境 也 太好了
蛋 为什么 这么 黑	野 鸡蛋 我日 微博 评论 发 不了 图片 了
野 鸡蛋 我日 微博 评论 发 不了 图片 了	瞧不起 你
瞧不起 你	你 牛 逼 你 发给 我 看看
取关	为何
为何	我 的 朋友 都 是 有钱 的 和 聪明 的
我 的 朋友 都 是 有钱 的 和 聪明 的	哈哈哈哈 那 你 呢
哈哈哈哈 那 你 呢	我 不是 吗
我 不是 吗	你 拥有 了 你 的 朋友 们 就 拥有 了 他们 的 一切 所以 你 是 最美 最 有钱 的
皮肤 好好	才 发现
才 发现	才 说 而已
用 的 什么 东西 排毒 的	意志力
意志力	哈哈
怎么 来	多 吃水果 蔬菜 啊
多 吃水果 蔬菜 啊	我 以为 不 吃饭 只 喝水
我 以为 不 吃饭 只 喝水	那 也 太 没 技术性 了
那 也 太 没 技术性 了	我 也 要 瘦
我 也 要 瘦	我 主要 是 乱 吃 的 像 中毒 了 一样
我 主要 是 乱 吃 的 像 中毒 了 一样	我 竟 无言以对
你 去 写生 了	没有 出去 转转 啊
没有 出去 转转 啊	哦 那 你 说 你 在 宿舍
哦 那 你 说 你 在 宿舍	这是 下午 晚上 我 还 不该 回来 嘛
想要 网红 同款 墨镜	打包 拿走
打包 拿走	不 客气
藕花 有 想 我 吗	想 你 了 潇潇
想 你 了 潇潇	哈哈 我 也 想 你 哈来 了 就 赶紧 看 你
哈哈 我 也 想 你 哈来 了 就 赶紧 看 你	哈哈 谢谢 潇潇 啦
三张 图 一个 景 变化 的 只有 天上 的 云朵 和 水中 鸭儿 的 身影	那 是 一个 瞬间 拍下 的 自然 哈哈 看 得 仔细
那 是 一个 瞬间 拍下 的 自然 哈哈 看 得 仔细	嗯 哼
嗯 哼	心里 美美 哒
心里 美美 哒	有 好事 可以 一起 分享
有 好事 可以 一起 分享	说 你 呢
说 你 呢	嗯 我 没 哇 把 你 的 分享 出来
嗯 我 没 哇 把 你 的 分享 出来	我烦 着 呢
我烦 着 呢	看 有没有 兴趣 听 了
看 有没有 兴趣 听 了	讲正闷 着 呢
没有 看见 文章内容	友好 好久不见 嗯 还 没 写 呢 只是 今天 刚刚 开通 博客 先写 两句 看看
友好 好久不见 嗯 还 没 写 呢 只是 今天 刚刚 开通 博客 先写 两句 看看	静候 佳作
静候 佳作	佳作 不敢 只是 用心 的 去 写 就 好
我 刚刚 开通 了 博客 先写 一篇 看看 没什么 特别 的	你 要 转移阵地
你 要 转移阵地	不是
藕花 我 又 来 了	潇潇 好 今天 到 哪 玩 去 啦
潇潇 好 今天 到 哪 玩 去 啦	哈哈 你 出去玩 了 吗
哈哈 你 出去玩 了 吗	到 玉渊潭公园 玩去 了 刚 吃过饭
到 玉渊潭公园 玩去 了 刚 吃过饭	美 啊 我 明天 出去玩
美 啊 我 明天 出去玩	放假 是 要 出去 玩玩 了 祝 明天 玩 的 开心
放假 是 要 出去 玩玩 了 祝 明天 玩 的 开心	么 么
么 么	哈哈 好玩
哈哈 好玩	再 给 你 来 个
再 给 你 来 个	真好玩 潇潇 你 太 有 才 了
真好玩 潇潇 你 太 有 才 了	哈哈 可爱 吧
哈哈 可爱 吧	拍 出土 来 了
吓 得 我 都 不敢 说 我学 了 三年 画	这么 夸张
这么 夸张	我画 的 菜
我画 的 菜	你 可以 画 的 比 我 的 好
你 要 变网 红 了	没有 网 红脸 所以 不能
没有 网 红脸 所以 不能	哈哈
哈哈	所以 嘛 .
画 的 还是 这么 好	可惜 就是 没有 画得 更好
可惜 就是 没有 画得 更好	没事 的 你 本来 就 很棒
没事 的 你 本来 就 很棒	谢谢 宝宝 呀 以后 会 更 棒
谢谢 宝宝 呀 以后 会 更 棒	么 么
有些 日子 没 更 了	有些 日子 没画 了
有些 日子 没画 了	懒 了
懒 了	是 有点 懒 以后 要 多 画
这是 条有 感情 的 微博	你 这么 厉害 还 能 看出 有 感情
你 这么 厉害 还 能 看出 有 感情	因为 我 就是 有 感情 的 人 这 你 没 发觉 嘛
因为 我 就是 有 感情 的 人 这 你 没 发觉 嘛	这个 理由 我 给 满分
这个 理由 我 给 满分	谢谢 老师 那 我 可以 提前 放学 了 哈哈哈哈
谢谢 老师 那 我 可以 提前 放学 了 哈哈哈哈	可以 拿 回家 要 奖励 了
可以 拿 回家 要 奖励 了	哦 放学 喽 老师 再见
哦 放学 喽 老师 再见	再见
画 的 那么 为何 不愿 给 我 画 一张	有 时间 的话 我 是 愿意 的
有 时间 的话 我 是 愿意 的	图片 评论
图片 评论	保持 微笑 会 很 美哟
好看	那 你 多 看 一眼
那 你 多 看 一眼	哈哈哈 哈哈 再 来 几眼
对 画画 好看 的 女生 有 好感	好像 在 暗示着 什么 呀
好像 在 暗示着 什么 呀	图片 评论
图片 评论	我 还是 不要 了
早 啊	放假 在家 被 妈妈 叫醒 吃 早点 的 我
放假 在家 被 妈妈 叫醒 吃 早点 的 我	哈哈哈 我妈 的话 七点 就 开始 叫 我 说 早餐 快 做 完 了 叫 我 快 起来
哈哈哈 我妈 的话 七点 就 开始 叫 我 说 早餐 快 做 完 了 叫 我 快 起来	我 是 不 起来 吃 等 会 接着 睡
我 是 不 起来 吃 等 会 接着 睡	哈哈哈
金鱼 惊恐 版	巨丑 鱼
巨丑 鱼	可是 你 心情 为啥 不好
可是 你 心情 为啥 不好	天气 太冷 不能 出门
好 专业 小学 初中 一直 学 画画 可惜 后来 没 在 坚持	怎么 不 坚持 下来
怎么 不 坚持 下来	后来 贪玩 就 不 喜欢 学了
小时候 的 我 也 会 画画	小时候 我画 的 很 好看
小时候 我画 的 很 好看	我区 三等奖
我区 三等奖	现在 呢
现在 呢	没动 过 画笔
没动 过 画笔	那 你 应该 画画
我 也 想学 画画	我 负责 画 你 负责 观看
我 负责 画 你 负责 观看	好 以后 多画点
好 以后 多画点	好 的 呀
天 啊 你 为什么 要画 虫子 最 讨厌 最 害怕 的 就是 虫子	可是 你 不 觉得 我画 的 虫子 很 可爱 嘛
可是 你 不 觉得 我画 的 虫子 很 可爱 嘛	吓死人 了 都 准确 地 说 是 吓死 我 了 反正 虫子 就是 可怕 的 生物
吓死人 了 都 准确 地 说 是 吓死 我 了 反正 虫子 就是 可怕 的 生物	还好 的 啦
还好 的 啦	女孩子 竟然 喜欢 画 虫子 你 可能 是 个 假 女孩
女孩子 竟然 喜欢 画 虫子 你 可能 是 个 假 女孩	哈哈哈哈 怎么 可能 我 是 小姐姐 哟
你家 的	同学 在 学校 养 的
同学 在 学校 养 的	还 能 在 学校 养 幸福 啊
还 能 在 学校 养 幸福 啊	在 外面 租房子 养 的 宿舍 不能 养
最后 一张 我 真的 笑 死 了	允许 了 你 笑 的 吗 死 猪
允许 了 你 笑 的 吗 死 猪	摇 你 像 上去 的
摇 你 像 上去 的	老子 我 是 自带 的 不是 上去 的
嘿嘿 就 这么 想 我 啊	好久没 看见 过 青蛙 嘴 了 确实 有点 想念
好久没 看见 过 青蛙 嘴 了 确实 有点 想念	不能 好好 交流 了
半夜三更 的 早点 睡 ! 不要 以为 不 长痘痘 了 就 嚣张	告诉 你 个 好消息 我 开始 跟 你 一样 长痘 了 开心 吗
告诉 你 个 好消息 我 开始 跟 你 一样 长痘 了 开心 吗	开心 因为 我 好 一段时间 都 不长 了
开心 因为 我 好 一段时间 都 不长 了	你 走 那 我 要 去 睡觉 了 就 凭 你 这话
你 走 那 我 要 去 睡觉 了 就 凭 你 这话	一起 睡 晚安 爱 你
这个 滤镜 咋 显得 你 嫩 个 黑	我白过 吗
我白过 吗	可爱 嘻嘻 嘻
又 背 到 爸爸 跟 别个 穿 情侣装 是不是	等 你 回来 爸爸 跟 你 一起 买 父女 装
等 你 回来 爸爸 跟 你 一起 买 父女 装	我父 你 女
我父 你 女	我 是 你 爸爸
腿 粗	丸 丸 不 在 有事 请 留言
丸 丸 不 在 有事 请 留言	你 只要 知道 你 腿 粗 就行了
她 是 个 坑 啊 不过 还好 我 坑 回来 了 哈哈哈	哦 反正 你们 就是 奥利 奥嘛
哦 反正 你们 就是 奥利 奥嘛	反正 你 就是 回 万州 嘛
突然 一下 想起 你 好不容易 请 我 一次	哪儿 有 好不容易
哪儿 有 好不容易	不是 迈和夏 一丹 一 对比
不是 迈和夏 一丹 一 对比	哈哈 你 在 笑 吗
好阔 爱 哟	你 喜欢 考古 吗
你 喜欢 考古 吗	啥子 批
啥子 批	没 啥 买 一只 回去
没 啥 买 一只 回去	买回去 谁养 天天 跟 我 跑 医院 吗
买回去 谁养 天天 跟 我 跑 医院 吗	放 家里 放 寝室 都 可以
放 家里 放 寝室 都 可以	只怕 是 哦
嗯 哼	嗯 哼 毛线
嗯 哼 毛线	你 过来 给 我 说来
你 过来 给 我 说来	你 过来
你 过来	你 等 着 哪 天西 我 西校 找 你 去
你 等 着 哪 天西 我 西校 找 你 去	我 天天 和 对象 黏在 一起 呢
我 天天 和 对象 黏在 一起 呢	嗯 哼 我 去 找 我 对象 顺便 把 你 看哈
骚情	哎呀 咋 了 矫情 一下 啦
哎呀 咋 了 矫情 一下 啦	先 把 微博 更新 了 就 允许 你
哟 换 了 个 手机 哦	滚 犊子
滚 犊子	这 几天 咋 的 不见 你
这 几天 咋 的 不见 你	我 隐居 山林 了
我 隐居 山林 了	出来 耍来
出来 耍来	你 在 哪 耍 呢
铺垫 呢 么 多发 就 发 呗	一语道破 天机 这样 的 孩子 大人 不 喜欢
一语道破 天机 这样 的 孩子 大人 不 喜欢	厉害 了 我 的哥
厉害 了 我 的哥	驾考 一路 走 好
驾考 一路 走 好	你 才 走 好 死 孩子 怎么 说话 呢
你 才 走 好 死 孩子 怎么 说话 呢	你 才 孩子 爸比 不 爱 你 了
说好 的 一起 玩 了	今天 哈 昨天 你 才 到 屋
今天 哈 昨天 你 才 到 屋	好 等 哈 出来 逮 电话
别 走	不 走 你 陪我玩
不 走 你 陪我玩	对 呀
就 应该 玩 九阴真经	我 现在 的 一个 玩游戏 的 朋友 他 昨天 说 他 室友 超级 喜欢 玩 九阴真经 我 说 你 也 玩 问 你 哪个 区 我 顺便 把 头牌 的 故事 说 了 一遍
我 现在 的 一个 玩游戏 的 朋友 他 昨天 说 他 室友 超级 喜欢 玩 九阴真经 我 说 你 也 玩 问 你 哪个 区 我 顺便 把 头牌 的 故事 说 了 一遍	她 室友 也 是 玩 的 是 手游 还是 网游
她 室友 也 是 玩 的 是 手游 还是 网游	网游
那 我们 约定 四 月底 去 重庆 买 衣服 虽然 上次 我 已经 买好 了 很多 夏天 的 了 嘻嘻 自从 跟 我 一个 朋友 逛街 以后 爱上 那种 感觉 了	和 我 一起 被 坑 的 感觉
和 我 一起 被 坑 的 感觉	哪儿 被 坑 了
哪儿 被 坑 了	坐车 吃面
好潮 哦 妹妹	准备 给 你 回复 上次 你 拿 包谷 坨 的 表情 包 的 居然 没 得 记录 了
准备 给 你 回复 上次 你 拿 包谷 坨 的 表情 包 的 居然 没 得 记录 了	哈哈哈 哈哈哈 哈哈哈 灯光师 摄像师 准备就绪 请 开始 你 的 表演
你 不 打扮 我	你 每天 打扮 的 那么 洋气
你 每天 打扮 的 那么 洋气	你 就 这样
你 就 这样	好
又秀 恩爱 真的 是	嘻嘻
嘻嘻	图片 评论
厉害 了 我 的 佳余	字里行间 透露 着 一种 基味
字里行间 透露 着 一种 基味	没错 是 基佬 们 的 味道
空间 发微 博发 没发 朋友圈 嘛	图古 没 一样 那 没 搞 点 花样 发嘛
图古 没 一样 那 没 搞 点 花样 发嘛	可以 可以 为 你们 点赞
梁总 好久不见 了 呗	是 过 阿波 总
是 过 阿波 总	有空 约 一波 呗
梁总笑 点 戏码 掰	图片 评论
图片 评论	哦 是 吗
哦 是 吗	哦 不是 吗
哦 不是 吗	图片 评论
梁 总得 放假 了 嘛	没放 啊 十一月 就 放假 了 嘛 直 总
没放 啊 十一月 就 放假 了 嘛 直 总	讲 这种 嘛 我们 已经 是 没有 书来 读 的 人 了
她 在 跟 我 喝酒	哈哈哈 哈哈 是 咩 发 照片 给 我 掐 颈
哈哈哈 哈哈 是 咩 发 照片 给 我 掐 颈	哈哈哈哈 你 怎么 懂 是 他
喝 了 两杯 就 冲动	酒壮 怂人胆 酒后 吐真言
酒壮 怂人胆 酒后 吐真言	整 词儿 ?
哇 喔 第一次 看 你 发微博	哇 什么 还 不 回来 读书 快点
哇 什么 还 不 回来 读书 快点	晚上 到校
厉害 了 我 的 苗	哈哈哈 你 以后 算 定居 北京 了
哈哈哈 你 以后 算 定居 北京 了	还 不 知道 暂时 会 在
好 喜欢	关注 喜欢 你 好久 了
关注 喜欢 你 好久 了	哈哈哈 今天 翻 牌子
哈哈哈 今天 翻 牌子	超 开心 哈哈哈
长安 好 可爱	抱住
抱住	腰好 粗 抱 不住
腰好 粗 抱 不住	多转 几圈 抱
多转 几圈 抱	嘿嘿
这句 话 可能 只是 用来 说明 相对 其他 参数 来说 性格 很 重要 优先级 很 高	其实 可以 这么 说 人 的 命运 分为 命定 的 层面 加上 主观 能动性 的 层面 主观 能动性 就是 性格 一个 传统 的 人 和 一个 有 冒险 精神 的 人 可能 一个 做 了 公务员 另 一个 下 了 海
其实 可以 这么 说 人 的 命运 分为 命定 的 层面 加上 主观 能动性 的 层面 主观 能动性 就是 性格 一个 传统 的 人 和 一个 有 冒险 精神 的 人 可能 一个 做 了 公务员 另 一个 下 了 海	你 这个 主观 能动性 跟 客观 能动性 的 分法 还是 挺 有意思 的 从 这个 角度 来说 的话 十几二十年 前 改革 开发 互联网 不 发达 敢 冒险 的 人 似乎 很多 都 改变命运 了 主动 能动性 改变命运 还是 挺 有 说服力 的 现在 社会 稳定 了 互联网 极端 发达 知识 时代 来临 而且 贫富 差异 越来越 大 主观 能动性 似乎 越来越 难 改变命运 了
什么 电影 博主 告知 一下 呗 我 也 看看	秋之白华 好像
秋之白华 好像	嗯 嗯 好 的 没想到 你 也 在 啊 我 一会 去 搜下
嗯 嗯 好 的 没想到 你 也 在 啊 我 一会 去 搜下	恰好 看到 了
可真 好看	你 也 好看 丹丹 我们 很久很久 没有 见 了 吧
你 也 好看 丹丹 我们 很久很久 没有 见 了 吧	对 啊 感觉 好几年 了 都
好 了 你 死 了 别 说话	怎么 和 姐姐 说话 呢 打 你 哦
怎么 和 姐姐 说话 呢 打 你 哦	嗯 你 是 美死 的
嗯 你 是 美死 的	你 就 知道 你 想 夸 我 拐弯抹角 的 一哈
你 就 知道 你 想 夸 我 拐弯抹角 的 一哈	搞笑
搞笑	你 再 不要 搞笑 忍不住 就 忍不住 这木个 可 咋 哩 你 最 爱 我 你 最 想 我 在 你 心里 眼里 我 最 完美
你 再 不要 搞笑 忍不住 就 忍不住 这木个 可 咋 哩 你 最 爱 我 你 最 想 我 在 你 心里 眼里 我 最 完美	你 又 欺负 我 从小 就 欺负 我
我们 的 血液 中 天生 带有 古香 我 骄傲 我 是 华夏儿女	对 早点 休息
对 早点 休息	晚安
你 撒 专业	传媒
传媒	自愧不如
自愧不如	武松 你 谦虚 了 你 不 喝酒 谁 能 喝酒
赞同	我 不敢 说 自己 一定 清明 知晓 世事 但 不 了解 自己 国家 魅力 所在 的 人太多 了 有 多少 人能 出口成章 不思进取 崇洋媚外 好高骛远 的 人 也 太 多 了 那些 前辈 们 可是 文思泉涌
我 不敢 说 自己 一定 清明 知晓 世事 但 不 了解 自己 国家 魅力 所在 的 人太多 了 有 多少 人能 出口成章 不思进取 崇洋媚外 好高骛远 的 人 也 太 多 了 那些 前辈 们 可是 文思泉涌	所以 我读 了 中文系 觉得 中国 传统 文化 浩如烟海 读之思 之 更是 令人叹服 而 如今 很多 人 失掉 了 传统 力 我 一直 觉得 经典 的 是 世界 的 而 一个 国家 的 文学 与 文化 是 一个 国家 的 魅力 所在
好美 等 我 瘦	你 本来 就 不 胖 啊 啊
你 本来 就 不 胖 啊 啊	假象 还是 有点 小胖 的
假象 还是 有点 小胖 的	没有 啦 真的 不胖
好 喜欢	这辈子 大概 无法 见到 你 了
这辈子 大概 无法 见到 你 了	最近 心情 太差 了
最近 心情 太差 了	心情 好 了 来 找 我 心情 不好 也 可以 来
在 云水 涧 还是 水云 涧 我 有点 懵 了 反正 就 这 俩个 名字	哈哈哈 都 不 对 是 水云间 这 不是 我家 妹纸 嘛
哈哈哈 都 不 对 是 水云间 这 不是 我家 妹纸 嘛	哈哈哈 这样 喔
好 喜欢 你 拍 的 复古 类型 的 啊	有 机会 给 姐姐 你 拍
有 机会 给 姐姐 你 拍	等 我 考完试 有 时间 去 找 你 玩
等 我 考完试 有 时间 去 找 你 玩	等 你 哦
请问 小姐姐 这 是 用 柔 焦 还是 柔 光镜 啊 好好看	没有 用柔 焦 后期 加 的 柔光
没有 用柔 焦 后期 加 的 柔光	嗯 嗯 谢谢
嗯 嗯 谢谢	不 客气
哇 哦 棒棒 哒	留下 各种 记忆 就 好
留下 各种 记忆 就 好	真的 这 几年 转 了 大半个 中国
真的 这 几年 转 了 大半个 中国	幸福
这是 自我 激励 啊 宝贝	加油
加油	想 你
想 你	爱 你
也 就 王自琦 不怎么 玩微博 否则 我 事情 大 了	截图 发送 王子 琦
截图 发送 王子 琦	裴序 元 还是 坏 的 啊
裴序 元 还是 坏 的 啊	不 不是 指 截图 发送 王子 琦 的 表情
不 不是 指 截图 发送 王子 琦 的 表情	你 就是 怕 我 不 出事
我 在 呢 啊	哈哈哈
哈哈哈	搞 事情
已经 被哥 铲 掉 了 花盆 都 撇 了	那 不管 他 永远 留在 了 我 的 心里
那 不管 他 永远 留在 了 我 的 心里	呵呵 哒
呵呵 哒	你 怎么 忍心 把 他 铲 掉
你 怎么 忍心 把 他 铲 掉	奶奶 说 碍眼
奶奶 说 碍眼	这么 残忍 的话 还 不如 别说
这么 残忍 的话 还 不如 别说	我 怎么 可能 不说
我 怎么 可能 不说	那 我 假装 相信 他 自己 化 了
这大 眼睛 啧啧 啧	大 吗 我 咋 没 感觉
大 吗 我 咋 没 感觉	挺大 的 眼睛 大 了 就是 好看
挺大 的 眼睛 大 了 就是 好看	我 的 眉毛 是不是 太 黑
我 的 眉毛 是不是 太 黑	真的 不是 一般 的 黑染 眉膏染 一下
真的 不是 一般 的 黑染 眉膏染 一下	那 是 已经 染过 的
那 是 已经 染过 的	染眉膏 是 假 的
染眉膏 是 假 的	不 可能 刚买 的
厉害 了	厉害 啥
厉害 啥	美白 加磨 皮加 瘦 脸
美白 加磨 皮加 瘦 脸	屁 明明 是 一键 美颜
屁 明明 是 一键 美颜	排位 走
排位 走	不去 一天到晚 就 知道 打游戏
染眉膏	我 说 我 用 完才 是 这么 个 你 信 吧
我 说 我 用 完才 是 这么 个 你 信 吧	无说
无说	今天 本来 说 的 做 去 呢 做 眉毛 的 人 说 的 我 的 越做越 黑快 算了
深夜 狗 粮真 把 我 喂饱 了	哈哈 早上好
哈哈 早上好	好个 粑 粑
可以 可以 越来越 了	并 没
并 没	还 谦虚 的 不行
这 镜头 和 电脑 不 匹配 啊	什么 意思
什么 意思	至少 来个 吧
至少 来个 吧	奥 你 说 相机 啊 这个 够 平时 拍点 简单 东西 了 我 的 水平 也 就 会 用 这个
奥 你 说 相机 啊 这个 够 平时 拍点 简单 东西 了 我 的 水平 也 就 会 用 这个	哈哈 好 吧 买 个定 焦拍 吧
哈哈 好 吧 买 个定 焦拍 吧	哈哈 等 我 技术 高超 了 再说
哈哈 等 我 技术 高超 了 再说	电脑 是 你 的 嘛
电脑 是 你 的 嘛	当然 是 公司 的 了
佳能 感动 常在	累死 不 感动
累死 不 感动	哈哈
是 啥	我 想 对 你 翻白眼 没 这个 表情
我 想 对 你 翻白眼 没 这个 表情	哈哈哈 你 可以 对 我 比心
哈哈哈 你 可以 对 我 比心	比粑 粑
比粑 粑	没爱 了
没爱 了	爱 你 在 心 口难开
爱 你 在 心 口难开	想 我 了 没
想 我 了 没	嗷嗷 想 你
嗷嗷 想 你	敷衍 杭州 一 下雨 我 就 开始 想 你们
敷衍 杭州 一 下雨 我 就 开始 想 你们	哈尔滨 一下 雪 我 就 开始 想 你
哈尔滨 一下 雪 我 就 开始 想 你	杭州 天天 下雨 哈尔滨 已经 不 下雪 了 吧
杭州 天天 下雨 哈尔滨 已经 不 下雪 了 吧	咋 可能 不想 你 了
拍 的 一手 好图 要 不 大神 带带 我	不敢 瞎 拍
不敢 瞎 拍	不 不 不 真是 大神
哈哈	是 我 吧
是 我 吧	没 啊 还是 辣 么 美
我 喜欢 辣个 戴眼镜 的 短发 女孩子	哈哈 她 看到 一定 很 开心
哈哈 她 看到 一定 很 开心	她 会 看到 的
这 啥	咒语
咒语	不是 歌 吗
不是 歌 吗	像 歌谣 一样 的 咒语
为啥 要 穿 学士 服	我们 院要 拍 啥 宣传 视频
我们 院要 拍 啥 宣传 视频	哈哈哈 一定 是因为 长 的 美
哈哈哈 一定 是因为 长 的 美	谢谢 学弟
恭喜 摆 一桌 吧	我要 胖 摆 什么 桌
我要 胖 摆 什么 桌	帮助 你 突破 大关 啊
怎么 这么 可恶	啊 哈哈 什么 时候 才能 到斤 啊 好 愁 哦
啊 哈哈 什么 时候 才能 到斤 啊 好 愁 哦	多喝水
你 去 了	我 准备 去 呼市
我 准备 去 呼市	哟 西 我 去 大连
好 可爱 呀	第一个 俗名 叫 屁股 有木有 很 形象
第一个 俗名 叫 屁股 有木有 很 形象	哈哈哈哈 好 形象
你 可以 试试	要 翻墙
要 翻墙	不用
鸡汤 静	鸡汤 静讲 的 每 一句 话 都 是 生活 的 感悟
鸡汤 静讲 的 每 一句 话 都 是 生活 的 感悟	很 有 道理 喜欢
什么 什么 比赛	君哥 啥时候 约 一场 球
君哥 啥时候 约 一场 球	等 比赛 以后 啊
等 比赛 以后 啊	行行 等 咱们 打 完 比赛 娱乐 娱乐 君哥
行行 等 咱们 打 完 比赛 娱乐 娱乐 君哥	我 在 养伤 中
我 在 养伤 中	快养 好 啊 君哥 要 打 比赛 了
快养 好 啊 君哥 要 打 比赛 了	嗯 嗯 你 也 加油
嗯 嗯 你 也 加油	嗯 呐
小学 弟 加油 啊	这 是 谁
这 是 谁	你 爸爸 呀
这个 鞋子 不是 老 舒服 了 么	减速 好 震感 不好
减速 好 震感 不好	涨 姿势 了
白 衣服 好看 店 在 哪里 啊	甘 南路 醒莲 酒吧 对面 往东米
甘 南路 醒莲 酒吧 对面 往东米	微 信号 我加 你
微 信号 我加 你	微博有 二维码 哦 置顶 那条
微博有 二维码 哦 置顶 那条	扫 不 出来
你 这个 口红 颜色 还 可以 诶	就是 诶
就是 诶	有勒们 好看
有勒们 好看	已经 进 了 的 坑
已经 进 了 的 坑	无法自拔
是 的	都 没有 理由 不 开心
都 没有 理由 不 开心	哈哈 天气 太 重要 了
哈哈 天气 太 重要 了	今年 的 春天 来得 太晚 了
这个 男生 好像 没见 过	屁 以前 班 的 你 绝对 见 过 好 吗
屁 以前 班 的 你 绝对 见 过 好 吗	好 吧
那个 到底 是 啥子 我 一直 以为 点 开会 动	就是 会动 呀
就是 会动 呀	为 啥子 我 的 不动 版本 问题
为 啥子 我 的 不动 版本 问题	以上 才 可以 吧
下次 把关 了	我 故意 没关 的
我 故意 没关 的	那 你 很 棒棒 哦
长 了 木 不 抓紧 减着	夏天 要 到 了 留给 我们 的 时间 不多 了
夏天 要 到 了 留给 我们 的 时间 不多 了	你 又 不 胖
你 又 不 胖	我 想 再 减 一点
我 想 再 减 一点	瘦成 啊
瘦成 啊	不 不 不 那 太 夸张 啦
不 不 不 那 太 夸张 啦	哈哈
你 在 这儿 不 联系 我	我 才 到 才 找到 住 的 地方
我 才 到 才 找到 住 的 地方	在 哪儿 嘛 准备 呆 好久
在 哪儿 嘛 准备 呆 好久	在 邛海 边上 明 晚上 回去 过来 出差
在 邛海 边上 明 晚上 回去 过来 出差	哎呀呀 该 你 安逸 了 明天 三十度 哦
哎呀呀 该 你 安逸 了 明天 三十度 哦	我 穿 的 大衣 秋裤 都还没 脱
天有 两头 小仙露 还有 还有 我 好 喜欢 陈绮贞	因为 你 喜欢 所以 我 喜欢
因为 你 喜欢 所以 我 喜欢	天 你 被湾湾 的 甜言蜜语 完全 浸泡 了 好 甜
天 你 被湾湾 的 甜言蜜语 完全 浸泡 了 好 甜	哪有
太 幸福 了 吧	对 呀
对 呀	羡慕 死 啦
羡慕 死 啦	今年 真的 是 运气 比较 好
中国队 跪 了	对 啊 这个 怂 必须 认了
对 啊 这个 怂 必须 认了	哈哈哈 不 怂 啊
老哥	哈宝
哈宝	你 这样 对 一个 在外 漂泊 的 人 真的 好 吗
你 这样 对 一个 在外 漂泊 的 人 真的 好 吗	我 一直 不 知道 你 漂泊 在外 只是 浪 吧
我 一直 不 知道 你 漂泊 在外 只是 浪 吧	扎心 了 老铁
故事 不敢 听	来 我 给 你 讲 一只 绣花鞋 吧
来 我 给 你 讲 一只 绣花鞋 吧	装开 了
装开 了	能 不能 愉快 的 玩耍 了
酒肉 准备 上 把 我 找 来	你 的 故事 不 精彩
你 的 故事 不 精彩	很 精彩
都 有 男票 还 说 个 毛	可是 分手 了 啊
可是 分手 了 啊	你 这话 我 没法 接 啊
上火 了	哈哈哈 去 成都 那 几天 的 照片 现在 好 了
哈哈哈 去 成都 那 几天 的 照片 现在 好 了	但是 也 很 好看
以后 不能 看 你 的 微博 了	你们 都 坏 坏
你们 都 坏 坏	我 也 敲 胖胖
好 喜欢 好 喜欢	我 也好 喜欢
我 也好 喜欢	简直 美玩 几天
简直 美玩 几天	东北 一共 有 七天
中山装 吗	嗯 呢
嗯 呢	为 撒 表演 节目 啊 吗 相亲 啊
为 撒 表演 节目 啊 吗 相亲 啊	和 你 相亲 啊 嘛
和 你 相亲 啊 嘛	不敢 我 配不上 你
不敢 我 配不上 你	你 咋 是 个 鸟货
你 咋 是 个 鸟货	啦 啦 啦 狗 几把 哥
啦 啦 啦 狗 几把 哥	神经
狗哥 真 几把 帅	海源 叫 我 鸡巴 哥
海源 叫 我 鸡巴 哥	狗 鸡巴 哥
狗 鸡巴 哥	好 你 等 我 回来
看 我	看 你 你 好看 嘛
看 你 你 好看 嘛	你 还 不 知道 我 好不好 看
你 还 不 知道 我 好不好 看	可能 忘记 了
大 早上 的 不 睡觉 你 准备 日 谁	睡不着 于是
睡不着 于是	这个 天打 野战 有些 冷
这个 天打 野战 有些 冷	有 空调
有 空调	那 就 不够 野
发现 你 以后 浪 的 不行	咋 了 吗
咋 了 吗	骚浪 贱 你 全 占 了
美 和 路子 在 一起 吗	你 回来 了 吗
你 回来 了 吗	嗯 嗯 你 撒 时候 有 时间
嗯 嗯 你 撒 时候 有 时间	我 一直 有 时间
嘿嘿 爱我吗	爱 你 哟
爱 你 哟	哈哈
丫丫 这张 太丑	不丑 啊 不用 瘦 脸针 都 那么 完美 羡慕 不
不丑 啊 不用 瘦 脸针 都 那么 完美 羡慕 不	顶 屁用 还是 丑 哼
顶 屁用 还是 丑 哼	本来 就是 蛮乖 蛮 乖 的 我 又 没 说 过 我 是 美女
本来 就是 蛮乖 蛮 乖 的 我 又 没 说 过 我 是 美女	哈哈哈哈 好 嘛 听 你 的
哈哈哈哈 好 嘛 听 你 的	嘿嘿 就是 这么 自信 哦
我 给 老爸 老妈 改善 了 下 伙食 刚 躺 下	精神 好 我 刚 睡醒 胃疼 炸 了
精神 好 我 刚 睡醒 胃疼 炸 了	你 是 吃 多 了
够 够 的 了	来 出来 打雪仗
来 出来 打雪仗	我 在 平凉
才 回 学校 就 这么 浪	今天 一天 课要 累死
今天 一天 课要 累死	我 才 起来
我 才 起来	喔 都 上 了 两个 小时 的 课 了
喔 都 上 了 两个 小时 的 课 了	哈哈哈
饿 了	哈哈哈 我们 一起 饿 着
哈哈哈 我们 一起 饿 着	看 你 作嘛 害人害己
看 你 作嘛 害人害己	网红 不要 生气
网红 不要 生气	网红 快要 被 饿死 了
欢迎 回家	哈哈
哈哈	冷
两瓶 半	你 好好 说
你 好好 说	边缘 疯狂
出粮 呀	我 最近 放假 在 撸 应该 是 官配
我 最近 放假 在 撸 应该 是 官配	表示 脐带
路 是 自己 走 出来 的 帅哥 加油	谢谢
谢谢	我 喜欢 另 两字
创业 不 在 扬子江 做 推广 经理 了	一边 工作 一边 创业
一边 工作 一边 创业	哈哈 好 吧
不笑 也 是 二 傻子	绝交
绝交	爆照 拍 好 的
真 尼玛 磕碜	黑鬼 滚
黑鬼 滚	儿贼 听话儿
熊比 你 可爱	再说 自杀
再说 自杀	处 对象 吗 分手 追 你 砍 你 一条街 的 那种
处 对象 吗 分手 追 你 砍 你 一条街 的 那种	要 问问 我 手里 的 熊 答不答应
要 问问 我 手里 的 熊 答不答应	你 答不答应 你 答应 的话 直接 让 熊 跟 我 回家 见 爸妈
难道 这个 真的 不是 装饰	妹妹 你 太 可爱 啦
妹妹 你 太 可爱 啦	原来 真的 不是 装饰
收花 啦 美美 的 做成 干花 可以 放 很 久	不会 做 呀 以前 的 都 弄 上 灰 了 不 好看 了
不会 做 呀 以前 的 都 弄 上 灰 了 不 好看 了	倒挂 在 通风 遮阳 的 地方 就 可以 了 很多 灰 空气质量 不太好
倒挂 在 通风 遮阳 的 地方 就 可以 了 很多 灰 空气质量 不太好	是 忘 了 管 它 了 一年 才 想 起来
饭后 一支 烟 赛过 活神仙	你 憋 抽哈对 身体 不好
你 憋 抽哈对 身体 不好	我 不 抽烟 谢谢 你 的 关心
我 不 抽烟 谢谢 你 的 关心	真乖
真乖	说 的 我 很 开心
我 不 喜欢 烟味儿 闻着 喉咙 不 舒服	小葵 蚊子 都 讨厌 烟味
小葵 蚊子 都 讨厌 烟味	对 对 对
我 以前 也 在 公交车 上 看书 但 我 从来不 是 学霸	这 孩子 不是 看书 是 做题 任何 场合 能 拿 出来 做 题 才能 是 学霸
这 孩子 不是 看书 是 做题 任何 场合 能 拿 出来 做 题 才能 是 学霸	学霸 和 学渣 的 区别
这个 可以 直接 下载安装 版 也 可以 刷 系统	安装 版本 是 指 的 什么 刷 系统 是 指
安装 版本 是 指 的 什么 刷 系统 是 指	安装版 就是 开发 成 一个 的 软件 刷 的 意思 就是 通过 盘 安装 镜像 如果 是 软件 比 镜像 要 方便 得 多得多 如果 是 镜像 就 稍微 麻烦 一点点
什么 时候 正式版 发布 已经 饥渴 难耐 了	就 今天 呀 你 没有 收到 消息 么
就 今天 呀 你 没有 收到 消息 么	没有 收到 啊 可以 自动 升级 吗 还是 要 手动
没有 收到 啊 可以 自动 升级 吗 还是 要 手动	你 居然 信 了
我 的 是 . 能 通过 在线 方式 升级 吗	没有 加 过 内测 测试 源 的 就 不行 哦
没有 加 过 内测 测试 源 的 就 不行 哦	那 没法 了 只有 全新 安装 了 顺便 问下 下 翻墙 的 软件 有 没
那 没法 了 只有 全新 安装 了 顺便 问下 下 翻墙 的 软件 有 没	你 怎么 能 这么 问 呢 找 你 谈话 啊
你 怎么 能 这么 问 呢 找 你 谈话 啊	哈哈 今天 会 不会 来查 我 水表 谢谢 啦
哈哈 今天 会 不会 来查 我 水表 谢谢 啦	有人 敲门 千万别 开
有人 敲门 千万别 开	我装 上 了 但是 用不来 没有 可用 的 免费 的 代理服务器 地址 和 密码 有 没 分享 一个 嘛
我装 上 了 但是 用不来 没有 可用 的 免费 的 代理服务器 地址 和 密码 有 没 分享 一个 嘛	那个 还是 要 你 自己 弄 这个 上架 就 已经
那个 还是 要 你 自己 弄 这个 上架 就 已经	我 有 百度 盘 可以 分享 不 或者 邮箱 .
我 有 百度 盘 可以 分享 不 或者 邮箱 .	这个 真 没有
回去 试试 昨晚 下 的 . 今天 就 出 . 了 在 . 里面 能 增量 更新 到 . 吗	现在 是 版本 最好 是 全新 安装 .
现在 是 版本 最好 是 全新 安装 .	度 胖子 你 终于 回 我 了
度 胖子 你 终于 回 我 了	我进 深度 了 原来 因为 我装 了 固态 硬盘 所以 要 手动 将 普通 磁盘 设 成 第一 启动项 才能 看到 深度 的 系统 选择项
等 适应 高后 就 能 用 了	并 不 在 这个 版本 的 计划 中
并 不 在 这个 版本 的 计划 中	屏小到 看不见 只能 拿 凑合 用
屏小到 看不见 只能 拿 凑合 用	反正 它 在 年 计划 里面
度 胖子 昨晚 上 装机 到 十二点 多 还是 没装 上 安装 完成 之后 要 我 拔出 盘 以免 我 再次 进入 安装 界面 我照 做 了 但是 系统 选择 界面 并 没有 看到 我 进去 用 启动项 修复 工具 也 看不到 我装 在 盘 上 在 我 的 电脑 里面 已经 看不到 盘 了 接下来 我要 怎么 做	你 的 是 几 我 的 进 把 深度 系统 调 为 第一 启动项 如果 喜欢 用 系统 的话 可以 在 深度 系统 里调
你 的 是 几 我 的 进 把 深度 系统 调 为 第一 启动项 如果 喜欢 用 系统 的话 可以 在 深度 系统 里调	你 说 的 调 第一 启动项 是 类似 于 把 盘 设成 第一 启动项 一样 吗 我 以为 只要 在 系统 引导 页面 选择 直接 进入 就 可以 了 可是 系统 选择 界面 并 没有
你 说 的 调 第一 启动项 是 类似 于 把 盘 设成 第一 启动项 一样 吗 我 以为 只要 在 系统 引导 页面 选择 直接 进入 就 可以 了 可是 系统 选择 界面 并 没有	嗯 安装 成功 以后 里会 有 深度 的 启动项 调 到 第一 才 会 有 系统 引导 界面
嗯 安装 成功 以后 里会 有 深度 的 启动项 调 到 第一 才 会 有 系统 引导 界面	. 到 . 好像 只能 重装
这个 服务器版 的 操作系统 有 龙芯 版本 的 吗	你 居然 有 龙芯 电脑 哪 一款
你 居然 有 龙芯 电脑 哪 一款	跑 卡不卡
跑 卡不卡	不卡
有 一首 普吉岛 都 在 放 的 歌 节奏 和 这首 很 相似 不 懂 歌曲 名字 叫 什么	有 地址 发来 瞧瞧
有 地址 发来 瞧瞧	斯 米兰 群岛 的 快艇 和 大巴 司机 都 在 放 的
你 看看 那个 二十分钟 的 预告 也 能 知道 是 怎么 回事儿 了	我 在 看 了 在 我 追 第一部 的 时候
我 在 看 了 在 我 追 第一部 的 时候	漂洋过海 还有 第一部 ?
漂洋过海 还有 第一部 ?	阿 我 还 以为 你 跟 我 说 的 大唐 荣耀 你 别剧 透 我 想 好好看 完 这部 剧 特别 喜欢 朱亚文 和 王丽坤 这 俩 还 拍 一块儿 去 了
又 转去 了 我 也 想	我 星期三 就 转来 的
我 星期三 就 转来 的	原来 已经 回去 两天 了 明天 还要 补课 你们 班 没课
原来 已经 回去 两天 了 明天 还要 补课 你们 班 没课	莫 啊 我 是 请假 啊 上个星期 就 请 的
莫 啊 我 是 请假 啊 上个星期 就 请 的	任性 了 我 的 姐
喝 了	没有
没有	红 什么 呢
红 什么 呢	会 变天
会 变天	你 脸 是 天气预报
你 脸 是 天气预报	女生 红脸 会 变天 男生 红脸 会 天晴 这是 老一辈 人 说 的
女生 红脸 会 变天 男生 红脸 会 天晴 这是 老一辈 人 说 的	这样 啊
我 有 供应商 送 这些 的 你 要 联系方式 问下 吗	嗯 嗯 可以 告诉 我 联系方式 吗
嗯 嗯 可以 告诉 我 联系方式 吗	黄石 这边 的 那家 没有 二氧化碳 有 二氧化碳 的 是 武汉 的 你 要 哪家
黄石 这边 的 那家 没有 二氧化碳 有 二氧化碳 的 是 武汉 的 你 要 哪家	我 需要 二氧化碳 氮气 我 在 黄石 大冶 地区
我 需要 二氧化碳 氮气 我 在 黄石 大冶 地区	他 那边 可以 送 我 也 是 在 黄石 上班 买 武汉 的
他 那边 可以 送 我 也 是 在 黄石 上班 买 武汉 的	我 做 精酿 啤酒 和 氮气 咖啡 他们 是 食品级 的 吧
我 做 精酿 啤酒 和 氮气 咖啡 他们 是 食品级 的 吧	那 估计 不是 的 我 以为 也 是 工厂 的
要 请问 是 黄石地区 的 吗	是 黄石 的 不过 二氧化碳 我 是 在 武汉 买 的 光气 开票 是 瓶子 是
是 黄石 的 不过 二氧化碳 我 是 在 武汉 买 的 光气 开票 是 瓶子 是	应该 是 有 规格 的 一
应该 是 有 规格 的 一	的 瓶子 气体 纯度 不 一样 价格 也 不 一样
长 了 潮虫 才 是 真的 潮	那 你 见 过 没有 壳 的 蜗牛 吗
那 你 见 过 没有 壳 的 蜗牛 吗	并 . 并 没有
萧敬腾 还 在	貌似 今天 不 在
貌似 今天 不 在	赶紧 出去 晒 晒太阳
图一 莫名 心疼 .	是 啊 第一次 看到 的 时候 就 超级 心疼
是 啊 第一次 看到 的 时候 就 超级 心疼	那 就是 嵩哥 的 原则
还是 你 比较 厉害	已 删评 许嵩 话题 里 那条 带 马赛克 博主 信息 的 微博 并 艾特博主 本人 的 微博 如果 是 你们 闹着玩 的 那 我 无话可说 但是 我 不是 脑残 谢谢
已 删评 许嵩 话题 里 那条 带 马赛克 博主 信息 的 微博 并 艾特博主 本人 的 微博 如果 是 你们 闹着玩 的 那 我 无话可说 但是 我 不是 脑残 谢谢	不 客气
之前 竟然 说 祝英台 是 男生 扮演 的 翻 了 一下 官博 发现 是 女生 瞬间 安心 了	好像 就是 男 的 啊
好像 就是 男 的 啊	在 官博 找到 是 个 女 的 叫 陈梦希
在 官博 找到 是 个 女 的 叫 陈梦希	之前 不是 说 反串 我 还 雷 了 好久
之前 不是 说 反串 我 还 雷 了 好久	幸好 换 了
许嵩 四月 三十	你 确定 四月 三十 号 吗
你 确定 四月 三十 号 吗	不是 啦 猜会 拖 到 月末 去
不是 啦 猜会 拖 到 月末 去	不能 吧 应该 预热 吧 我 觉得 再 过 几天 就 能 出
我嵩 的 歌 没上 第一 那 是因为 都 是 普通人 听不来 也 听不懂 他 的 歌	听嵩哥 的 人 什么 年龄层 都 有 长期 受嵩哥 熏陶 也 都 是 比较 低调 的 除了 许嵩 发新歌 那 几天 粉丝 拼命 给 他 打 榜 其余 时间 基本 也 是 跟 许嵩 一样 完 沉默
听嵩哥 的 人 什么 年龄层 都 有 长期 受嵩哥 熏陶 也 都 是 比较 低调 的 除了 许嵩 发新歌 那 几天 粉丝 拼命 给 他 打 榜 其余 时间 基本 也 是 跟 许嵩 一样 完 沉默	这话 我 赞同 以前 我 也 很 疯狂 但是 现在 工作 了 真的 和 以前 不 一样 了 但是 每次 发新歌 就 开心 到 不行
老强 你 说 你 这么 棒 我 都 感觉 我 配不上 你 了	不 能够 你 必须 是 我 的
不 能够 你 必须 是 我 的	可是 你 越来越 棒 了 感觉 自己 啥 都 不会
可是 你 越来越 棒 了 感觉 自己 啥 都 不会	不会 啦 宝贝儿 你 的 执念 和 勇气 我 一直 爱着
原配	我 是 说 原来 她 在 对 你 放电
我 是 说 原来 她 在 对 你 放电	太 幸福 了 你 飞吻 回去 没
太 幸福 了 你 飞吻 回去 没	我 都 哪 还 想 的 起来 飞吻 回去
强哥 画工 越来越 好 了 可以 传授 一 经验 不 也 不错	经验 就是 多 看 多 画
经验 就是 多 看 多 画	越来越 服 你 了
娘子 不是 这样 的 听 我 解释	一喊 娘子 芝姐 铁定 不 哭 了
一喊 娘子 芝姐 铁定 不 哭 了	好 吧 官人 我 再 给 你 次 机会 以后 不许 再 伤害 我 了 呜呜 呜呜
好 吧 官人 我 再 给 你 次 机会 以后 不许 再 伤害 我 了 呜呜 呜呜	长舒 一口气 说 终于 逃过一劫
长舒 一口气 说 终于 逃过一劫	再有 下次 我 就
再有 下次 我 就	芝姐 不要 遇见 你 之后 我 只 爱 你 一个 从 年 表白 到 年 爱 的 坦荡荡
芝姐 不要 遇见 你 之后 我 只 爱 你 一个 从 年 表白 到 年 爱 的 坦荡荡	好 了 我们 回家吧
好 了 我们 回家吧	终于 哄 好 了
终于 哄 好 了	真 美好
真 美好	美好 的 时光
美好 的 时光	会 一直 这样 美好 下去
搞 事情	事情 是 谁
事情 是 谁	事情 是 一个 人
羡慕	宝宝 们 都 有 机会 的
宝宝 们 都 有 机会 的	好 哒 好 哒 相约
我 也 想要	下次
下次	好 的 我 等 着
可能 吧	我要 把 我 的 包上 贴点 容易 分辨 的 东西 这样 太 恐怖 了
我要 把 我 的 包上 贴点 容易 分辨 的 东西 这样 太 恐怖 了	我 老公 的 真的 是 没想到 我 自己 的 都 很 花 很 好认
我 老公 的 真的 是 没想到 我 自己 的 都 很 花 很 好认	那个 贱人 也 太 有 心机 了 这 是 得 盯 你们 多久 啊 如果 是 第一次 看到 你们 就 这么 巧合 同包 那 真是 碰到 鬼 了 都
那个 贱人 也 太 有 心机 了 这 是 得 盯 你们 多久 啊 如果 是 第一次 看到 你们 就 这么 巧合 同包 那 真是 碰到 鬼 了 都	包 的 牌子 不 一样 但是 款式 确实 比较 接近
你 就是 太 真相	所以 呢
所以 呢	所以 被 人 挂
所以 被 人 挂	握草 又 被 挂 了 这么 快
握草 又 被 挂 了 这么 快	没有 没有 我 是 说 小心 被 人 挂
没有 没有 我 是 说 小心 被 人 挂	阴魂不散 跟 主子 一样 讨人厌
我 觉得 杨景修 主要 是 为了 彼党 他 认为 国党 土共 相争 是 历史 的 必然 曾经 的 师长 亲人 变成 敌人 虽然 残忍 但 也 无可奈何 杨景修 认同 国党 统一 的 国家 宋 长官 认同 太平 安定 的 国家 所以 在 政治立场 上 两个 人 还是 有 分歧 的	所以 说景修 奉行 得 三民主义 不过 是 对 党国 的 愚忠 罢了
所以 说景修 奉行 得 三民主义 不过 是 对 党国 的 愚忠 罢了	可以 说 是 这样 杨景修 确实 不如 宋 红菱 另外 我 觉得 还有 一点 就是 在 当时 那个 时间 节点 上国党 没有 人 认为 自己 会输 他们 觉得 消灭 我土 共 只是 分 分钟 的 事 在 这种 错觉 下 很多 事情 不会 深入 的 去 思考 毕竟 对于 宋杨 来说 消灭 了 土共 等于 获得 了 和平
小美女	刚才 发短信 的 就是 我 啦
刚才 发短信 的 就是 我 啦	我 知道 的
必须 啊 好吃 不 贵 老板 帅	我 朋友 做 得 美图 拜托 妹纸 帮 我 转发给 男神 曹炳琨 可好 谢谢 希望 今后 还 能 为 男神 做 更 多 美图
我 朋友 做 得 美图 拜托 妹纸 帮 我 转发给 男神 曹炳琨 可好 谢谢 希望 今后 还 能 为 男神 做 更 多 美图	谢谢 你 的 转发 你 可以 私信 发给 他 啊 哥能 看到 的
谢谢 你 的 转发 你 可以 私信 发给 他 啊 哥能 看到 的	私信 你 了
还是 这个 拍 的 自然 比 剧照 帅多 了	这俩 大 眼睛 的
这俩 大 眼睛 的	看 了 这么 多 合影 跟 你 拍 的 最最 随性
看 了 这么 多 合影 跟 你 拍 的 最最 随性	哈哈哈
地址 在 哪里 曹 老板 的 店 吗	嗯 呢 在 北京 朝阳区 工体 西路 号 顺着 胡同 进来 就 能 看到
嗯 呢 在 北京 朝阳区 工体 西路 号 顺着 胡同 进来 就 能 看到	那得 去 光顾
梳理 时尚 脉络 完美 时光 剪影 .	你 怎么 在 义乌
你 怎么 在 义乌	你 认识 我
你 认识 我	哈哈 现在 不 就 认识 了 吗 缘 来自 网络
哈哈 现在 不 就 认识 了 吗 缘 来自 网络	哦 哦
商量 个 事儿 呗	今晚 来 陪 我 睡 可好 外边 雨大 怕怕
今晚 来 陪 我 睡 可好 外边 雨大 怕怕	哈哈哈哈 哈哈哈哈
你 女朋友	你 猜 啊
你 猜 啊	应该 不是 我 想 你 没 这么
应该 不是 我 想 你 没 这么	过个 节 而已 嘛
晓港港 你 太棒 啦	你 咋 才 来 不 开心 都 一天 了
你 咋 才 来 不 开心 都 一天 了	才 登微博 啦
好 精彩 啊	你 来 啦
你 来 啦	嗯 嗯 好久没 来看 啦 最近 忙 着 考试 了
嗯 嗯 好久没 来看 啦 最近 忙 着 考试 了	随时欢迎 你 来 考试 加油 哦
随时欢迎 你 来 考试 加油 哦	谢谢 呢
写得 太好了	哈哈 谢谢 你 支持 呀 夸 的 我 一阵 窃喜 哈哈 我会 继续 好好 写 的
哈哈 谢谢 你 支持 呀 夸 的 我 一阵 窃喜 哈哈 我会 继续 好好 写 的	真的 写 得 好 我 才 夸 你 啊 我 不会 随便 夸人 的 你 值得 夸 期待 你 写 得 更 精彩
真的 写 得 好 我 才 夸 你 啊 我 不会 随便 夸人 的 你 值得 夸 期待 你 写 得 更 精彩	我会 加油 哒 哈哈 也 期待 你 继续 围观
我会 加油 哒 哈哈 也 期待 你 继续 围观	你 是 读 什么 专业 的 能 说 吗
你 是 读 什么 专业 的 能 说 吗	额 这个 还是 保密 吧 哈哈哈
额 这个 还是 保密 吧 哈哈哈	谢谢
谢谢	你 是不是 觉得 我 像 读 中文系 的
你 是不是 觉得 我 像 读 中文系 的	我 看 你 文字 工底 觉得 是 编辑 方面 的 具体 就 不 知道 了
我 看 你 文字 工底 觉得 是 编辑 方面 的 具体 就 不 知道 了	嘻嘻 其实 我学 的 是 管理 类 的 表示 当年 也 很 想学 编辑 之类 的
嘻嘻 其实 我学 的 是 管理 类 的 表示 当年 也 很 想学 编辑 之类 的	拥有 一手 好 的 文字 工底 对 以后 管理 也 很大 的 帮助 的 写 管理 方案 总结
拥有 一手 好 的 文字 工底 对 以后 管理 也 很大 的 帮助 的 写 管理 方案 总结	哈哈 是 的 呀 是 的 呀 很 开心 今天 遇见 你
哈哈 是 的 呀 是 的 呀 很 开心 今天 遇见 你	好好 努力
是 啊 是 啊 我 要是 玉良哥 我 先 把 俩 人 给 拉开 再 给 白莲花 一耳瓜 太 心疼 玉良哥 了 为了 这么 个 绿茶 不值 当 啊 真是 从头 虐到 尾 他 要是 一来 遇见 的 就是 大 小姐 该 多 好	更 喜欢 景修 是因为 女主 没 这么 渣玉良 的 深情 让 我 好气 哦 觉得 不值 景修 的 深情 我 觉得 特别 美好
更 喜欢 景修 是因为 女主 没 这么 渣玉良 的 深情 让 我 好气 哦 觉得 不值 景修 的 深情 我 觉得 特别 美好	是 啊 玉良哥 感觉 是 被 坑 了 而 景修 他 的 深情 至少 还有 回报 我 红菱 小姐姐 是 既 不作 也 不 白莲花 啊
太爱玉良哥 了 超过 景修	大爱玉良哥 哈哈 在 我 这儿 我 姑爷 还是 排 第一 的 哈哈 不过 玉良哥 真心 虐 啊 心疼 我哥 一万年
大爱玉良哥 哈哈 在 我 这儿 我 姑爷 还是 排 第一 的 哈哈 不过 玉良哥 真心 虐 啊 心疼 我哥 一万年	大概 是因为 我 先 看 的 玉良哥 后 看 的 姑爷 吧 总是 忘不了 他 在 曾家 大院 眼睁睁 看着 绿茶 跟 二少爷 一起 时 那个 大 眼睛 眨 呀 眨 那个 样子 看着 就 心疼
鹿晓港 鲸 落 海洋 靳歌 金曲 郑 豆豆 之前 的 不能 看 了 这 是 新 链接 谢谢你们 的 喜欢	为什么 我 还是 看 不了
为什么 我 还是 看 不了	不会 吧 你 点 那个 摄像机 的 图 标点 进去 就可以看 了
不会 吧 你 点 那个 摄像机 的 图 标点 进去 就可以看 了	可以 啦 可以 啦
欢沁 是 什么	就是 林海 的 欢沁 跟着 这个 节奏 走路 的 速度 刚好
就是 林海 的 欢沁 跟着 这个 节奏 走路 的 速度 刚好	哇 这 调子 太 出名 了
我 看 的 时候 还 差 好 几十条	蘑菇 们 勤奋 的 猝不及防
蘑菇 们 勤奋 的 猝不及防	对 呀 明明 都 随腾哥 懒得
对 呀 明明 都 随腾哥 懒得	你 看过 一千 没人刷 了 吧
你 看过 一千 没人刷 了 吧	扎心
缘分 是 件 奇妙 的 事儿 可能 从 那年 的 小剧场 就 注定 了 之后 的 故事 吧 珠联璧合 的 二位 老师 不管 对于 生活 还是 舞台 都 有 过分 的 默契 别人 也 羡慕 不 来 如果 生活 和 舞台 非要 选 一个 他们 也 都 会 心照不宣 的 选择 舞台 演员 和 导演 对 二位 来说 是 更好 的 关系 吧 一本正经 的 胡说	舞台 是 最 神圣 的 所以 舞台 上 的 你 也 一定 是 最 重要 的
舞台 是 最 神圣 的 所以 舞台 上 的 你 也 一定 是 最 重要 的	对 我 最 重要 了
北京站 是 北京 所有 火车站 里 最烂 的 一个 站 但是 人生 百态 也 是 最 多 的 因为 其他 的 站 高铁 居多 北京 这个 城市 有 他 独特 的 魅力 让 人 想 逃走 又 想 靠近	是 的 里面 人流 串动 形形色色 的 人 都 有
是 的 里面 人流 串动 形形色色 的 人 都 有	上 了 火车 听 着 人们 谈话 就 更是 了
上 了 火车 听 着 人们 谈话 就 更是 了	嗯 我会 留意 的
可想而知 当初 看 貂蝉 踹 马超 的 那个 视频 我 就 很 期待 尧 柯版 的 貂蝉	真的 她 肯定 經典
真的 她 肯定 經典	期待
只是 小小 護理師 啦 職業病 作祟	鸭梨 山大 呀
鸭梨 山大 呀	哈哈哈 早安 記得 吃 早餐 喲
哈哈哈 早安 記得 吃 早餐 喲	嗯 你 也 是 呦
嗯 你 也 是 呦	有 喔 剛吃 飽 了
铜矿 即糖 累 了 下线 睡觉 吧	嘻嘻 晚安 偶 滴水 希望 明天 他俩 努力 营业
嘻嘻 晚安 偶 滴水 希望 明天 他俩 努力 营业	希望 吧
哈哈哈 可能 是 的	心塞
心塞	没事 去 看 重播 遍
没事 去 看 重播 遍	妥妥 哒
无法 想象 会裂 的	不仅 会裂 还 会 爆
不仅 会裂 还 会 爆	专业 人员 来 解答
那么 请问 许仙 真的 会上 原型 的 白素贞 吗 画面 太 美	巨型 黄鳝
巨型 黄鳝	可是 许仙 是 男 的
可是 许仙 是 男 的	男 的 就 不行
男 的 就 不行	你 玩个 我 看看
你 玩个 我 看看	要 灌肠 的
要 灌肠 的	娘子 太 巨型 心疼 我 仙哥
原来 你 还 记得 微博 密码 啊	那还用说
那还用说	欢迎 欢迎
欢迎 欢迎	傻宣
小 状元 你 这 一天天 的 伤春悲秋 你 爹 看到 了 开心 都 要 变成 伤心 了	不会 他 指不定 哪 嗨 着 呢 唉 可怜 天下 粉丝 心 噢 都 要 熬 成 汤 了
不会 他 指不定 哪 嗨 着 呢 唉 可怜 天下 粉丝 心 噢 都 要 熬 成 汤 了	小 状元 你 怎么 不 出来 浪 了 熬 成 汤 了 喝喝 也 是 大补 啊
本来 是 看 我 老 赵来 的 我 老林 突然 就 登场 了	老林 ? 是 指林 美瞞 老师 么
老林 ? 是 指林 美瞞 老师 么	不是
不是	那 是 ?
那 是 ?	你 有 老鷹 不管 管起 小雞來 了 就 那個 人
你 有 老鷹 不管 管起 小雞來 了 就 那個 人	好 吧 然 来说 的 是 林 教主
清明节 播	观音大士 粗线 了
观音大士 粗线 了	清明节 不播 就 端午节
清明节 不播 就 端午节	你 这 是 哪路 来 的 观音大士 ?
这 音乐 我服 了 我 承认 我 神经 了	彻底 被 洗脑 了 么 ?
彻底 被 洗脑 了 么 ?	只能 说 你 的 一个 无心 之作毒 到 我 了
不 知道 为什么 一直 都 没有 播	月份 不会 有戏 了 期待 月份 吧
月份 不会 有戏 了 期待 月份 吧	要是 不播 怎么办
要是 不播 怎么办	应该 不至于 吧 只能 说 等 的 时间 可能 久 一点 罢了
应该 不至于 吧 只能 说 等 的 时间 可能 久 一点 罢了	反正 能播 就 好
啥事 候才 是 的 哇	猜 是 下 一期 吧
猜 是 下 一期 吧	好久 哇
本体 啊 本体	我 觉得 没有 岁 吧
我 觉得 没有 岁 吧	也 可能 两岁
给 好吃 的 就 温柔	这里 有 故事
这里 有 故事	行 吧 我 就 不问 了
去 不 我 带上 你 你 带上 钱	晶走 啊
晶走 啊	蜜月旅行 土耳其 好 不
蜜月旅行 土耳其 好 不	晶好 呀 好 呀 据说 那 也 很 美
来自 铁蹄 的 开心	你 为什么 天天 在 刷 微博 你 是不是 有瘾
你 为什么 天天 在 刷 微博 你 是不是 有瘾	铁蹄 闭嘴 都 是因为 微博向 我 推荐 了 你 的 消息 我 也 不 知道 为什么 推荐 你 给 我
铁蹄 闭嘴 都 是因为 微博向 我 推荐 了 你 的 消息 我 也 不 知道 为什么 推荐 你 给 我	可能 因为 我 是 一个 网红
可能 因为 我 是 一个 网红	网铁 吧
这 小姑娘 说话 真 厉害	还 真是 哪 都 有 你
还 真是 哪 都 有 你	哈哈
洪山 广场 好远	是 学校 远 吧
是 学校 远 吧	是 啊 平常 又 不能 住 屋里
贼 羡慕 上半身 没有 肉肉	说 得 像 你 有 肉样 周瘦 人
说 得 像 你 有 肉样 周瘦 人	哇 我 说 你 很 不讲道理
哇 我 说 你 很 不讲道理	咦 你 也 是 不讲道理 的 小姐姐
为啥 大家 都 剪短 发了 剪头发 有瘾	洗头发 节约 了 起码 分钟
洗头发 节约 了 起码 分钟	而且 感觉 头 很 轻 是不是
你 的 翘 马尾 没有 了	那 你 还 爱我吗
那 你 还 爱我吗	爱 你 依旧
爱 你 依旧	好 咧
是 什么	有个 欢乐 中国 人 的 综艺 应该 是 最新 一期 你 去 看看
有个 欢乐 中国 人 的 综艺 应该 是 最新 一期 你 去 看看	好 我 看看
有 饭局 也 不 说 一声	小 饭局 怕 你 不来 啊
小 饭局 怕 你 不来 啊	再 小 也 是 局
再 小 也 是 局	下次 互叫
是 小石 锅 谢谢	正 一味 也 不错
正 一味 也 不错	省 着 点 您 的 电 吧 谢谢
又 开始 装逼 了	你 在 我 男神 课上 干嘛 呢
你 在 我 男神 课上 干嘛 呢	那个 时候 哪里 上课 了
那个 时候 哪里 上课 了	上课 都 不 知道
上课 都 不 知道	我会 不 知道
我会 不 知道	你别 指 我 你 过来
青岛 的 花 都还没 开好 冷 呀	嘿嘿 等 暖和 些 就 开 啦
嘿嘿 等 暖和 些 就 开 啦	嗯 呐 等 着 呐
这 下巴	照出来 就是 这样 可以 说 是 非常 吓人 了
照出来 就是 这样 可以 说 是 非常 吓人 了	可以 开 核桃 了
可以 开 核桃 了	哈哈哈哈 你 怎么 那么 烦
哈哈哈哈 你 怎么 那么 烦	图片 评论
什么 鬼	没什么 啦
没什么 啦	你 完 了
我 建议 直接 去 找 那个 他 总比 我们 这种 读 了 书 还 考不上 的 好	不要 这样
不要 这样	和 你 互关 的 他 不 知道 会 不会 打开 这 条 评论 哦
和 你 互关 的 他 不 知道 会 不会 打开 这 条 评论 哦	求 放过
求 放过	你 还 秒 回 啊 可以
哈哈哈 你 咋 知道 我 也 想 截图 这个	这个 太帅 了 打破 我 和 彬彬 视频 二百 分钟 的 记录 必须 截图 保存
这个 太帅 了 打破 我 和 彬彬 视频 二百 分钟 的 记录 必须 截图 保存	我 刚才 看到 也 震惊 你 了 然后 看微博 你 也 发 了 哈哈哈哈 哈哈哈
我们 也 很久没 见 了	你 要 跟 我 见面 吗
你 要 跟 我 见面 吗	哈哈哈 要 啊
你 左 先生 还是 右 先生	感觉 走 在 了 马路 中间
感觉 走 在 了 马路 中间	无论 你 是 左 先生 还是 右 先生 我 都 喜欢 可是 你 偏偏 走 在 了 马路 中间
无论 你 是 左 先生 还是 右 先生 我 都 喜欢 可是 你 偏偏 走 在 了 马路 中间	因为 我时 左时 右 啊
只 剩下 了 这个 猴子 他 还是 一个 人	是 啊
是 啊	只有 他 还是 那么 的 孤独
你 的 字 真 好看 我 类哥	谢谢 我 类弟
谢谢 我 类弟	给 我 写个 签名
给 我 写个 签名	有空 给 你 写
有空 给 你 写	好 的 等 你 哟
好 的 等 你 哟	猴猴 猴
我要 留长 头发 了	然而 我要 剪短 发了
然而 我要 剪短 发了	啥时候 剪 啊 剪成 多长 啊 我 亲自 给 你 操刀
啥时候 剪 啊 剪成 多长 啊 我 亲自 给 你 操刀	这 段时间 吧 还 不 确定 要 剪短 发
这 段时间 吧 还 不 确定 要 剪短 发	多短用 我 不同 的 时期 来 说明 我 瞧瞧
多短用 我 不同 的 时期 来 说明 我 瞧瞧	跟 你 头像 长度 差不多 吧
想 吃	焖 锅 走 起
焖 锅 走 起	啥 是 焖 锅 我 在 等 外卖 饿死 了
啥 是 焖 锅 我 在 等 外卖 饿死 了	焖 锅 如图 我 还 没 吃
焖 锅 如图 我 还 没 吃	看着 可 好吃 啊
看着 可 好吃 啊	实际上 也 可 好吃 不行 不行 流口水 嘻嘻 嘻嘻
实际上 也 可 好吃 不行 不行 流口水 嘻嘻 嘻嘻	云 吃 了
云 吃 了	嘻嘻 你 最 可爱
不用 想 了 你 真傻	我 也 晓得 你 真傻
我 也 晓得 你 真傻	嗯 嗯 我 也 觉得 自己 有点 傻
嗯 嗯 我 也 觉得 自己 有点 傻	哎呀 又 是 个 什么 鬼
哎呀 又 是 个 什么 鬼	有 一天 我 发现 你 朋友圈 把 我 屏蔽 了 所以 我 很 知趣 自己 动手 删 了
有 一天 我 发现 你 朋友圈 把 我 屏蔽 了 所以 我 很 知趣 自己 动手 删 了	原来 是 这样 他 挺 好 的
你 骄傲 了 么	你 管 我
你 管 我	嗯 校长 快 找 你 谈话 了
劳资 天天 都 在 地球 上 都 没敢 说 出来	发现 了 一个 惊天大 咪咪
发现 了 一个 惊天大 咪咪	别 自卑
这首 歌唱 的 是 我 嘛	你 居然 听懂 了
你 居然 听懂 了	我 怎么 就 不能 听懂 了
你 就 已经 是 最白 的 了	是不是 加 了 黑 的 滤镜 还好 白
是不是 加 了 黑 的 滤镜 还好 白	是 是 是 黑 衬白
你 那个 然后 一 联想 就	还有 天 开学 傻
还有 天 开学 傻	我错 了
啥意思 啊	评论 完 我 就 后悔 了 我们 还 没 那么 熟 那样 说 不好
评论 完 我 就 后悔 了 我们 还 没 那么 熟 那样 说 不好	骂 我 是 吧 拉 黑
多 健身 好处 大大的	跟 你 学 的 励志 哥
跟 你 学 的 励志 哥	哈哈哈 撒 励志 哥
这脸 好像 你	哪里 会
哪里 会	脸型 不是 五官
突然 想 看 .	图片 评论
图片 评论	还 可以 .
袖子 一麻 拖 帕 一 甩 不 干 了	那 你 发 我 工资
那 你 发 我 工资	要 的 来 给 我 当 助教
过年 请 你 吃饭 生日快乐	你 也 是 要 快乐
你 也 是 要 快乐	你 快乐 我 快乐 咯
多久 没 看过 雪 了	确实 有 好久 啦 四川 没 这么 大 的 雪
确实 有 好久 啦 四川 没 这么 大 的 雪	是 这 样子 的
看见 你 在 卖 鞋扎心 了 老铁	少爷 不 来 慰问 我 一下 吗
少爷 不 来 慰问 我 一下 吗	以后 天天 慰问 你
以后 天天 慰问 你	谢谢 少爷 少爷 一天 不来 我 就 哭
在 哪里 兼职 啊	万象 城
万象 城	我 以前 兼职 也 碰到 过 很多 怪人
我 还 以为 第二 三张 图 加载 不 出来	哈哈哈 只有 仙女 才能 看到
哈哈哈 只有 仙女 才能 看到	早说 啊 我 先 变个 身
你 哭 是不是 因为 没娶 到 岁 想 娶 的 人	那 等 我 结婚 那天 我 想想 要 不要 哭
那 等 我 结婚 那天 我 想想 要 不要 哭	那 我 哭 肯定 是 害怕 以后 要 挨打
我 超爱 这部 电影 的	对 啊 超 好看
对 啊 超 好看	第一次 是 老师 拷 给 我 看 的 几十个 妈 的 这部 电影 太美 了
第一次 是 老师 拷 给 我 看 的 几十个 妈 的 这部 电影 太美 了	对 对 画面 都 很 美
第二张 是 你 吗	是 我 啊 头像 左边 是 你 吗
是 我 啊 头像 左边 是 你 吗	哈哈哈 不 知道 猪 怎么 叫
哈哈哈 不 知道 猪 怎么 叫	呼噜 呼噜
把 你 撩 走	哼 都 不 知道 你 在 忙 什么 了 在 北京 吗
哼 都 不 知道 你 在 忙 什么 了 在 北京 吗	这 几天 在 无锡
我 欣慰 的 是 你 去 喜欢 梁博 了 太好了 祝你们 长 长久 久别 来 抢 我 胡	哼 好好 好 不 知道 为什么 感觉 梁博 就是 我 的 男朋友
哼 好好 好 不 知道 为什么 感觉 梁博 就是 我 的 男朋友	我 突然 想 起来 你 的 臭 袜子 还 在 我 这里
我 突然 想 起来 你 的 臭 袜子 还 在 我 这里	我 拿走 了 好 吗
我 拿走 了 好 吗	我 都 忘记 了 没 看 还 以为 一直 伴随 着 我 入眠
我 都 忘记 了 没 看 还 以为 一直 伴随 着 我 入眠	要 知道 就 给 你 留下 了 就 像 我 陪 着 你
宝宝 今天 参加 复试 吗 完事 之后 可不可以 说 说 英语 都 是 啥 内容 哦	我 抽到 是 音乐 在 你 生活 中 扮演 什么 角色 你 最 爱 的 音乐 是 什么
我 抽到 是 音乐 在 你 生活 中 扮演 什么 角色 你 最 爱 的 音乐 是 什么	大 作文 和 小 作文 是 什么 啊
大 作文 和 小 作文 是 什么 啊	我们 没有 大小 作文 就是 抽 题目 自己 说
我们 没有 大小 作文 就是 抽 题目 自己 说	有 听力 和 自我介绍 吗 对 了 宝宝 你 是 去 渤海 大学 吗
有 听力 和 自我介绍 吗 对 了 宝宝 你 是 去 渤海 大学 吗	对 渤海 大学 听力 有 自我介绍 简单 准备 没有 时间 多 说 自我介绍
对 渤海 大学 听力 有 自我介绍 简单 准备 没有 时间 多 说 自我介绍	谢谢 你
谢谢 你	没事
今 还 偶遇 了 帅姐 阵营 渡人 与己 阿航 哈哈	真 漂亮
真 漂亮	过奖 过奖
哇 瘦 到 让 人 羡慕 哇	还 那样 啊 腿 粗 屁股 大
还 那样 啊 腿 粗 屁股 大	是 我 是 我
是 我 是 我	别 瞎说
这里 真 好	我 觉得 酒吧 挺 好 的 就是 酒 喝 不惯 哈哈
我 觉得 酒吧 挺 好 的 就是 酒 喝 不惯 哈哈	嗯 啊 挺 有 意境 的 炒 鸡 讨厌 慢摇吧 音乐 咣 咣 的 去过 一次 之后 再也 没有 去过
嗯 啊 挺 有 意境 的 炒 鸡 讨厌 慢摇吧 音乐 咣 咣 的 去过 一次 之后 再也 没有 去过	慢摇 都 没 去过 太乖 了 哈哈
鸣鸣 的 自拍 吼吼 看 哦	哪 呢 我 的 自拍
哪 呢 我 的 自拍	头像 呀
厉害 了 我 现在 还 申请 不了 信用卡	还是 不要 申请 了 不然 每个 月 都 要 还
还是 不要 申请 了 不然 每个 月 都 要 还	蚂蚁 花 呗 差不多
蚂蚁 花 呗 差不多	花 呗 也 一样 受不了 了
花 呗 也 一样 受不了 了	网购 起来 比 刷卡 还 快
网购 起来 比 刷卡 还 快	诱导 消费 啊
看不懂	多 看看 就 懂 了
多 看看 就 懂 了	还是 不 懂
你 又 去 上海 了	你 现在 住 哪儿 啊
你 现在 住 哪儿 啊	交大 那儿
一万 播放 没 人 转发 惨绝人寰	你 赶紧 花钱 去 让 营销 号 给 我 转
你 赶紧 花钱 去 让 营销 号 给 我 转	准 了 允许 你 花 一百块 请 水军
哈哈哈 好 逗 哇	对 哇 很 搞笑
对 哇 很 搞笑	忘 了 说 了 我 随便 画出 了 两个 妖刀
忘 了 说 了 我 随便 画出 了 两个 妖刀	我 本来 马上 非酋 初级 了 结果 来 了 一目 连 昨天 也 抽到 妖刀 了 接下来 小 目标 就是 茨 木 哥哥
我 本来 马上 非酋 初级 了 结果 来 了 一目 连 昨天 也 抽到 妖刀 了 接下来 小 目标 就是 茨 木 哥哥	啊 你 出 一目 欧洲人
你 这么 明目张胆 的 说 我 好 么	我 觉得 还 不错
我 觉得 还 不错	好像 很 厉害 的 样子
好像 很 厉害 的 样子	还有 一个 在 二 金字塔 顶端 的 人 还 没有 出现 冰洁
还有 一个 在 二 金字塔 顶端 的 人 还 没有 出现 冰洁	前两天 我 看到 照片 胖 了
前两天 我 看到 照片 胖 了	你 这样 不是 很 好
你 这样 不是 很 好	好 想 贴 照片 但是 怕 被 打
好 想 贴 照片 但是 怕 被 打	你 说 的 是 陈 睡衣 还是 我
你 说 的 是 陈 睡衣 还是 我	睡衣 啊
睡衣 啊	请发 照片
请发 照片	刚 找 了 下 不见 了
刚 找 了 下 不见 了	昂对 我 还 没 看过
昂对 我 还 没 看过	认真 再 找 了 下 真 没有
认真 再 找 了 下 真 没有	盆友 圈发 的
一大 把 年纪 也 是 难 为 你 了	我 觉得 我 的 手指头 异常 的 长 哈哈哈
我 觉得 我 的 手指头 异常 的 长 哈哈哈	别说 了 想 给 你 折 了
别说 了 想 给 你 折 了	哈哈哈哈 哈哈哈 哈哈哈 哈哈哈 嘛 绝 很 蛮
哈哈哈哈 哈哈哈 哈哈哈 哈哈哈 嘛 绝 很 蛮	这 只是 来自 短手 的 心里 独白
后面 几张 超帅 我 被 迷住 了	你 意思 是 后 两张
你 意思 是 后 两张	对 超级 帅
妈呀 哈哈哈哈 这是 可爱 少女 进化史	再 或者 这个
再 或者 这个	我 的 妈 哦 黑 历史 都 翻出来
我 的 妈 哦 黑 历史 都 翻出来	哈哈哈 哈哈 爱 你 很 么 么
古人 说 的 字 如其人 是 假 的 不过 你 的 字 写 的 好看 是 真的	你 是 说 字 好看 人丑 是 吧 打 洗 你 个 董大 坨
你 是 说 字 好看 人丑 是 吧 打 洗 你 个 董大 坨	我 这样 说 了 吗
啥 呀	老子 分手 了
老子 分手 了	来 和 我 恋爱 吧
来 和 我 恋爱 吧	正有此意
正有此意	等 你 的 临幸 哦
等 你 的 临幸 哦	熬夜 会变 老 哦
熬夜 会变 老 哦	我 已经 很 老 了 感觉 你 没 在 熬夜 一样
北京 的 一点点	啊啊啊 啊 在 哪里
啊啊啊 啊 在 哪里	是不是 在 建外 我 没 去 但 你 买 了 记得 给 我 也 买 一杯
是不是 在 建外 我 没 去 但 你 买 了 记得 给 我 也 买 一杯	哈哈哈哈 我 给 你 带
可怕 的 女人	那 你 还 和 我 一起 吃
那 你 还 和 我 一起 吃	美食 不可 辜负
我天 你 俩 都 这么 多年 啦	是不是 时光荏苒
是不是 时光荏苒	真是 过得 好 快 啊
男朋友 嘛	不是 哒 你 信嘛
不是 哒 你 信嘛	能 说 不信 嘛 笨蛋
我 的 臭屁 美媛 居然 都 没 认出来 是 姐姐	她 会 骄傲 的
她 会 骄傲 的	你 美 你 最美
苍山 上 是 雪 吗	是 的 终年 不化
是 的 终年 不化	不 啊 我 去年 写生 的 时候 就 没有 那 时候 九月
不 啊 我 去年 写生 的 时候 就 没有 那 时候 九月	可能 我 被 人 骗 了
可能 我 被 人 骗 了	我 感觉 是 的 .
因为 姐姐 真的 优秀 啊 老师 她 是 为 你 骄傲 啊	谢谢 你 但 我 知道 自己 几斤几两
谢谢 你 但 我 知道 自己 几斤几两	真的 啊 以前 我大一 的 时候 老师 每次 提前 你 的 时候 都 好 骄傲 上次 我 看见 老师 发 的 扣扣 日志 致 爱女 当时 特别 羡慕 姐姐 有 一个 好 妈妈 也 终于 明白 为什么 老师 提起 你 时 那么 骄傲 了 后来 老师 微信 转发 了 你 的 微博 文章 远大理想 我 就 进来 看 了 你 哦 你 真的 是 棒棒 哒 呢
真的 啊 以前 我大一 的 时候 老师 每次 提前 你 的 时候 都 好 骄傲 上次 我 看见 老师 发 的 扣扣 日志 致 爱女 当时 特别 羡慕 姐姐 有 一个 好 妈妈 也 终于 明白 为什么 老师 提起 你 时 那么 骄傲 了 后来 老师 微信 转发 了 你 的 微博 文章 远大理想 我 就 进来 看 了 你 哦 你 真的 是 棒棒 哒 呢	谢谢 妹子 欣赏 写作 就是 我 的 小 爱好 我 有 很多 毛病 例如 自律性 差 控制 欲强 倒 是 没 觉得 自己 优秀 看到 周围 有 很多 榜样 时常 会 警醒 自己 不能 成为 井底之蛙 切莫 满足 眼前 的 虚荣 你 也 要 努力 脚踏实地 祝福 你
谢谢 妹子 欣赏 写作 就是 我 的 小 爱好 我 有 很多 毛病 例如 自律性 差 控制 欲强 倒 是 没 觉得 自己 优秀 看到 周围 有 很多 榜样 时常 会 警醒 自己 不能 成为 井底之蛙 切莫 满足 眼前 的 虚荣 你 也 要 努力 脚踏实地 祝福 你	哈哈哈 好 的 一起 努力 呀
很 幸福 的 家人 的 爱 不 需要 多么 清醒 能 营造 出 温馨 的 港湾 就 很 幸福 了	偶尔 会 感到 尴尬 和 惭愧 所以 对 我 妈 这 一点 多少 有些 抗拒 我 可能 是 身 在 福中 不知 福
偶尔 会 感到 尴尬 和 惭愧 所以 对 我 妈 这 一点 多少 有些 抗拒 我 可能 是 身 在 福中 不知 福	甜蜜 的 负担 了
没有 跟 男朋友 的 合照 差评	这 我 该 如何 作答
这 我 该 如何 作答	崖 段 故意 耶
崖 段 故意 耶	重点 是 我 的 宿舍 桌子 很漂亮
重点 是 我 的 宿舍 桌子 很漂亮	那 我 几时 去 看看
很 悲伤	没有 小组 要 我们 了 毕竟 逃 了 第一节
没有 小组 要 我们 了 毕竟 逃 了 第一节	看看 能 不能 插进 不够 人 别的 组
我 刚才 发微博 的 时候 想发 世上 美女 千千万 只有 我 是 最好 看来 着 怕 被 打 就 没发	怕 啥
怕 啥	哈哈哈 下次 就 发
哈哈哈 下次 就 发	稳 了
哇 撒 感觉 你 好久没 更博 啦	嗯 嗯 在 学校 忙 的 要死 也 不愿 化妆 颓废 成
嗯 嗯 在 学校 忙 的 要死 也 不愿 化妆 颓废 成	哈哈哈 看 出来 啦
你 上 啥 班 今个 还 突然 发个 微博	爸爸 寒假 工 过年 人家 放 了 一个 星期 一点 都 不 关心 爸爸
爸爸 寒假 工 过年 人家 放 了 一个 星期 一点 都 不 关心 爸爸	你 还 好意思 说 我 过年 都 不 放假 你 也 没 说 关心 关心 爸爸
你 还 好意思 说 我 过年 都 不 放假 你 也 没 说 关心 关心 爸爸	儿子 越来越 嚣张
见过 两面 对话 那种 第一次 年 英国 志愿者 来 湖大 第二次 社团 联开 大会 学长 当 主席	加油
加油	感谢 学长 支持 鼓励 与 指点
姐姐 我 开车 被 撞 了	哈哈哈 哈哈哈 没事 吧
哈哈哈 哈哈哈 没事 吧	嗯 赔钱 呗 主要 是 沟通 烂 他 不 帮 我 打电话 要 我 自己 打
啥	感谢 遇见 你
感谢 遇见 你	我 也 不想 的
我 也 不想 的	还 真是 委屈 你 了
还 真是 委屈 你 了	那 不 没招 么
那 不 没招 么	那 你 也 可以 选择 不见
那 你 也 可以 选择 不见	哈哈哈哈
我天 你 发生 了 啥	没 赶上 高铁 坐 的 火车 今天 早上 在 车站 等 了 一个多 小时 又 坐 了 一个多 小时
没 赶上 高铁 坐 的 火车 今天 早上 在 车站 等 了 一个多 小时 又 坐 了 一个多 小时	我滴个 天 商务 座 也 没 啦
我滴个 天 商务 座 也 没 啦	站票 都 没 了
确定 不是 你 和 王 大陆	和 王 大陆 的 那个 小姐姐 演 过 步步 惊心 之前 就 觉得 她 长 的 像 中国 人 很 好看
和 王 大陆 的 那个 小姐姐 演 过 步步 惊心 之前 就 觉得 她 长 的 像 中国 人 很 好看	这位 亲 为什么 每次 回复 我 如此 官方
这位 亲 为什么 每次 回复 我 如此 官方	图片 评论
图片 评论	图片 评论
老哥 你 疯狂 偷拍 很	大 兄弟 开 手电筒 打电话 的 可 不多见 必须 双击
大 兄弟 开 手电筒 打电话 的 可 不多见 必须 双击	忘 了 是 什么 时候 了
忘 了 是 什么 时候 了	反正 疯狂 扣 就 对 了
哇 女神	请问 你 是 张 老 摆 吗
请问 你 是 张 老 摆 吗	我 是
请问 你 是	没 去 约会 还有 时间 给 我评
没 去 约会 还有 时间 给 我评	哈哈哈
老是 一个 姿势	白胡 咧咧
白胡 咧咧	你 自个 看看 来
这个 杰瑞 送 你 了	下脚料 不要 我要 更好 的
下脚料 不要 我要 更好 的	瞎说 这 是 最 好看 的 杰瑞
瞎说 这 是 最 好看 的 杰瑞	配上色 给 我
来自 小星星 的 期望	懂 完 了
懂 完 了	不敢 不敢
居然 出去 住 了	这 叫 逃荒
这 叫 逃荒	今晚 很 凉快
今晚 很 凉快	没关系 滴 总比 学校 好
苦 逼 的 大学	你 暑假 见到 我时 可能 就 黑成 这样 了
你 暑假 见到 我时 可能 就 黑成 这样 了	防晒霜 伺候 着
防晒霜 伺候 着	那 流汗 速度 防晒霜 并 没什么 卵用
那 流汗 速度 防晒霜 并 没什么 卵用	哈哈哈 等 着 你 回来
我 在 吹 着 我 的 小 吊扇	你 竟然 没 停电
你 竟然 没 停电	你 到底 是 住 几栋 哦
你 到底 是 住 几栋 哦	栋 啊
栋 啊	估计 是 没 电费 了
估计 是 没 电费 了	嗯 呐 来电 了 可是 没水
停电 了 艾玛 的	不是 停是 欠费 了 去 交费 吧
不是 停是 欠费 了 去 交费 吧	恐怖 停水 停电
这个 卫衣 小哥 是 谁	室友 啊
室友 啊	大脸 兔 眼睛 一眯 发现 事情 并 不 简单
本 以为 过上 了 春天 结果 一巴掌 拍回 冬天	我 也 是 没 穿 羽绒服 雪地 靴 回来 快 冻死 了
我 也 是 没 穿 羽绒服 雪地 靴 回来 快 冻死 了	你 太 任性 了 我 都 不敢 不 穿 羽绒服 回来
你 太 任性 了 我 都 不敢 不 穿 羽绒服 回来	雪天 已经 教 我 做人 了
雪天 已经 教 我 做人 了	多 穿 点别 感冒 了
多 穿 点别 感冒 了	嗯 哪 你 也 是
快 夸 我	夸毛
夸毛	我 拍 的 这么 美
咕噜 圆	闭嘴
闭嘴	顶 贪
大长 腿	谢谢 这位 粉丝 的 夸奖
谢谢 这位 粉丝 的 夸奖	我 这种 粉丝 下次 还是 希望 加个 前缀
我 这种 粉丝 下次 还是 希望 加个 前缀	好 的 谢谢 这位 帅到 无 边际 的 真爱粉 的 厚爱
行长 嫁 我	为 撒子 不 按 套路 清明节 说
为 撒子 不 按 套路 清明节 说	清明节 给 鬼 说 啊
清明节 给 鬼 说 啊	万一 鬼 喜欢 听浪个 办
生日快乐 做 精月 你 真 好 昨天 过节 今天 还 过生日	人家 是 女生节 生日 好 吗 做 精珂
人家 是 女生节 生日 好 吗 做 精珂	你 竟然 是 女生节 生日 天呐 我 以为 微博 系统 提醒 这天 就是 了 好 咯 迟到 的 生日 祝福 祝 你 越来越 水 越来越 做 精 啦
你 竟然 是 女生节 生日 天呐 我 以为 微博 系统 提醒 这天 就是 了 好 咯 迟到 的 生日 祝福 祝 你 越来越 水 越来越 做 精 啦	谢谢 你 这个 杂人 做 精就免 了 等 下出 社会 被 人 嫌弃 哈哈
撒 意思	没有 啦 这个 人微博 比较 酷
没有 啦 这个 人微博 比较 酷	我 昨晚 一个 噩梦 我 现在 一点 困意 都 没有
这南墙 我 是 撞 了 丢 了 的 自己 是 捡 不 回来 了 我 摔 得 最惨 的 地方 就是 我 重新 开始 的 位置 这 是 我 的 事情 我 自己 收拾	学妹 清早 感受 颇 多 不 清楚 在 你 身上 发生 了 什么 但 人 很 难得 的 是 保持 乐观 积极向上 的 心去 面对 任何 事 福建人 加油
学妹 清早 感受 颇 多 不 清楚 在 你 身上 发生 了 什么 但 人 很 难得 的 是 保持 乐观 积极向上 的 心去 面对 任何 事 福建人 加油	谢谢 学姐
我 每天 早上 六点 十五 就 起床 了 哎 都 不 晓得 一天 在 忙 啥	那么 早 我 每天 七点 十分 起床 都 觉得 睡 不够 一天 都 困
那么 早 我 每天 七点 十分 起床 都 觉得 睡 不够 一天 都 困	嗯 每天 都 坐车去 青白江
才 醒	上班 这么 苦 啊 我们 点 上班
上班 这么 苦 啊 我们 点 上班	泥 奏凯
泥 奏凯	加油 加油
生日快乐	么 么 扎
么 么 扎	嘿嘿
没有 我 的 皂片 差评	你 飞过来 玩 啊 就 有 哇
你 飞过来 玩 啊 就 有 哇	又 让 我 当浴 霸
又 让 我 当浴 霸	我怕 你 忘记 了 那种 感觉 快 来 重温 一下
我怕 你 忘记 了 那种 感觉 快 来 重温 一下	怎么 会 宝宝
怎么 会 宝宝	来 嘛 来 嘛 不要 害羞
快来 循 礼门 帮 我 手机 贴膜 现在 没人 帮 我 贴膜 了	你 把 手机 拿来 我 帮 你 贴
你 把 手机 拿来 我 帮 你 贴	我 马上 坐车去 纸坊
照骗	来 打 我 啊
来 打 我 啊	咋 还 没 睡 该 挨打 了
咋 还 没 睡 该 挨打 了	刚 打 了 把 王者
你够 了 二次 伤害	你 来 找 我 我 给你个 拥抱
你 来 找 我 我 给你个 拥抱	我要 吃 你 的 土豆片 哈哈哈 你 今晚 在 宿舍 不
我要 吃 你 的 土豆片 哈哈哈 你 今晚 在 宿舍 不	哈哈哈 可以 来 找 我 吃 土豆片
哈哈哈 可以 来 找 我 吃 土豆片	你 的 狗子 还有 两天 即将 抵达
你 的 狗子 还有 两天 即将 抵达	等 你
等 你	我 说 你 还有 两天 才 到
我 说 你 还有 两天 才 到	哈哈哈 够 了 等 我
哈哈哈 够 了 等 我	夫人 呐
夫人 呐	抱抱 你
你别 换来换去 每次 都 要 去 看 你 的 微博 相册 才 知道 你 是 谁 很 累 的	我 不
我 不	我 改 了 备注
北 看台 的 票 怎么 搞	可以 找 会长 买
可以 找 会长 买	认识 会长 不
认识 会长 不	之前 在 一个 球迷 协会 现在 没入
这个 怎么弄 的	你 打开 微博热 搜 就是 啦
你 打开 微博热 搜 就是 啦	哈哈哈
哈哈哈	么 么 哒
你 干 了 啥子 事	哈哈 你 看 你
哈哈 你 看 你	可以 的 小 吴 同学
可以 的 小 吴 同学	过奖 过奖
呀 呀呀 考 编制 嘛	对 呀
对 呀	好 厉害 加油 加油 !
哼 屁 吖	就 哼 你
就 哼 你	你 脑 抽风 吖
你 脑 抽风 吖	你 抽
你 抽	你 全 抽 了
读书 好 啊 丫头	嗯
嗯	工作 太 辛苦 啦
工作 太 辛苦 啦	找 一份 自己 喜欢 的 就算 辛苦 也 是 快乐 的 嘛
找 一份 自己 喜欢 的 就算 辛苦 也 是 快乐 的 嘛	这 社会 哪能 那么 如意 哦
天气 问题 基本 用 耳机 的 都 是 这样 我 直接 摘 耳机 不 听 了	同道中人
同道中人	听力 占能 保证 笔试 基本 全对 就 过 了
听力 占能 保证 笔试 基本 全对 就 过 了	谁 不 知道 你 老妈 是 女人
谁 不 知道 你 老妈 是 女人	听力 分 我 过 给 你 看
听力 分 我 过 给 你 看	我 等 着
我体 你 就 唔 到	别 小看 我
别 小看 我	都 这么久 了 闺蜜 之前 跟 你 足 膝 夜谈 也 无补于事
都 这么久 了 闺蜜 之前 跟 你 足 膝 夜谈 也 无补于事	需要 时间 嘛
文艺 女 青年 的 三大 魔咒	智硬
智硬	挺 自省 的 嘛 你
挺 自省 的 嘛 你	你 越来越 傻 了
你 越来越 傻 了	反正 不 聪明 傻人 有 傻福
听 我 的 单排 现在 九 连胜 了	我 擦 我 觉得 单排 更加 容易 输
我 擦 我 觉得 单排 更加 容易 输	单排 得 靠 自己 带 节奏 才行 因为 保证 不了 每局 队友 都 不 坑
单排 得 靠 自己 带 节奏 才行 因为 保证 不了 每局 队友 都 不 坑	问题 是 队友 坑 的话 自己 也 起不来 啊
问题 是 队友 坑 的话 自己 也 起不来 啊	刚输 一局 真的 不能 玩
刚输 一局 真的 不能 玩	现在 排位 我 不 单排 队友 坑 自己 也 起不来 也 坑
现在 排位 我 不 单排 队友 坑 自己 也 起不来 也 坑	我 已经 掉 下 黄金 了 来 排 吗
我 已经 掉 下 黄金 了 来 排 吗	我 现在 不 打 毕竟 周末 坑 更 多
我 现在 不 打 毕竟 周末 坑 更 多	全是 败方
全是 败方	现在 对 排位 有 阴影 我 现在 不 打 排位 都 打 匹配 练 英雄
现在 对 排位 有 阴影 我 现在 不 打 排位 都 打 匹配 练 英雄	我 之前 玩大号 也 是 玩出 阴影 了 死 都 不 打 排位
我 之前 玩大号 也 是 玩出 阴影 了 死 都 不 打 排位	反正 会 的 英雄 多 才能 更好 的 上 高 段位 打 匹配 练 英雄 也 挺 好 的
反正 会 的 英雄 多 才能 更好 的 上 高 段位 打 匹配 练 英雄 也 挺 好 的	我 就 会 十几个 英雄
我 就 会 十几个 英雄	你 还 会 十几个 我 回 的 就 几个 玩肉 的 会 很 坑
你 还 会 十几个 我 回 的 就 几个 玩肉 的 会 很 坑	看 了 一下 就 十三个 我 也 有 玩 的 特别 坑 的 英雄
看 了 一下 就 十三个 我 也 有 玩 的 特别 坑 的 英雄	我肉 不会 我主玩 的 还是 法师 和 射手
羡慕 我 就是 单排 但是 是 吸渣 体质 无奈	所以 我 现在 都 玩 小号
所以 我 现在 都 玩 小号	刚 又 输 了 我 一般 就 玩 鲁班 带不动 节奏 我 感觉 猴子 韩信 露娜 花木兰 这种 容易 带 节奏
刚 又 输 了 我 一般 就 玩 鲁班 带不动 节奏 我 感觉 猴子 韩信 露娜 花木兰 这种 容易 带 节奏	我 拿 兰陵王 带 节奏 的 喜欢 抓落 单一 抓 一个 准
我 拿 兰陵王 带 节奏 的 喜欢 抓落 单一 抓 一个 准	厉害 了 我 实在 玩 不了 刺客
厉害 了 我 实在 玩 不了 刺客	为啥 玩 不了
为啥 玩 不了	就是 学 不会 的 意思 不能 在 恰当 的 时候 抓人
就是 学 不会 的 意思 不能 在 恰当 的 时候 抓人	像 荆轲 妲 己 这些 比较 无脑 的 英雄 靠 的 是 意识 和 切入 时机 即使 无脑 还是 有些 人 玩 不好
像 荆轲 妲 己 这些 比较 无脑 的 英雄 靠 的 是 意识 和 切入 时机 即使 无脑 还是 有些 人 玩 不好	扩列 吗
来盘 王者 发泄 下	么 见 你 上线 麦
么 见 你 上线 麦	这 两天 一直 没 玩 今天 重下 了
如果 没有 成熟 和 充盈 的 心连 获得 友情 都 不 容易	这 世上 往往 有人 得天独厚 靠 的 不是 品质 和 性格 而是 相貌 和 技巧
这 世上 往往 有人 得天独厚 靠 的 不是 品质 和 性格 而是 相貌 和 技巧	是 的 呢
是 的 呢	不过 啊 人 以 类聚 我 还是 相信 真心 换 真心
不过 啊 人 以 类聚 我 还是 相信 真心 换 真心	我 也 相信 品格 和 性格 的 魅力 更 持久 永恒
你 得天独厚	那 你 不 了解 我 咯
那 你 不 了解 我 咯	我 觉得 你 很 好 感觉 不会错 你 说 对 不
不过 怎么 没脸 啊	哈哈 不同 框 的 身高 差
哈哈 不同 框 的 身高 差	这狗 粮 我 不吃
这狗 粮 我 不吃	不要 这样 嘛
有 故事 哦	我 男朋友
我 男朋友	很棒 加油 看好 你
永远 一个 角度	是 哦
是 哦	你 对比 头像
蛇 精病	小伙子 说话 要 负责 噶
小伙子 说话 要 负责 噶	妖怪 快 把 爷爷 还给 我
卖萌	我 不服 来 单挑
我 不服 来 单挑	我输 了
此情此景 我 想 吟诗 一首	什么
什么	没想 好
很 无奈 呀 天津 的 抢 不到	安慰 自己 济南 也 不远 天津 要是 加场 就 好 了
安慰 自己 济南 也 不远 天津 要是 加场 就 好 了	对 呀 而且 票贩子 是 真 可恶
原谅 我 只 看到 了 肉	还有 粉条
还有 粉条	那 不是 重点
那 不是 重点	你 的 重点 是 肉
我 和 大去 旅行	大 入住 加收 哈哈
大 入住 加收 哈哈	可以 找 老周
可以 找 老周	老周 要 加收 红
哇 喔 好 喜欢 啊	带 着 你 的 谁 来 呗
带 着 你 的 谁 来 呗	一定 会 去 的
一定 会 去 的	欢迎 骚扰
五一 有 一起 约 青海 的 吗	你 什么 时候 来 我 一直 在 青海
你 什么 时候 来 我 一直 在 青海	私聊
第一次 看 迈克 抽烟 的 照片 诶	迈克 不 抽烟 不 喝酒 不 吸毒 的 那 只是 他 摆 造型 而已 啦
迈克 不 抽烟 不 喝酒 不 吸毒 的 那 只是 他 摆 造型 而已 啦	哎呀 吓死 我 了 原谅 我 的 小 愚蠢
去 看海 了	不是 这 地方 叫 刘家峡 应该 算是 黄河
不是 这 地方 叫 刘家峡 应该 算是 黄河	黄河 我家 那边 也 有
话 说 他 和 的 时候 黛比 已经 怀 了 了 咱俩 在 这里 明目张胆 的 讨论 这些 待会儿 会 不会 被 赶走 ?	是 的 我 也 注意 到 你们 说 的 资料 的 时间 点 .
是 的 我 也 注意 到 你们 说 的 资料 的 时间 点 .	你 迈 很 风骚 啊
你 迈 很 风骚 啊	也 不知 当时 孩子 的 妈 知不知道 不过 当时 最 重要 是 安心 养胎 啦
也 不知 当时 孩子 的 妈 知不知道 不过 当时 最 重要 是 安心 养胎 啦	我 特地 向 某位 看过 书 的 博主 打听 的
到底 给 了 她 多少 好 东西	男女朋友 不 啪 啪啪 你 信 么
男女朋友 不 啪 啪啪 你 信 么	我 听说 里面 描写 了
我 听说 里面 描写 了	不看 都 知道 一定 很 火辣 各种 体位
不看 都 知道 一定 很 火辣 各种 体位	年 夏天 的 事情
年 夏天 的 事情	你 迈真忙 和 猫 女 离了婚 马上 找到 前女友 隔 几个 月 和 另 一个 女 人造 娃黛比 给 他 生娃 他 和 前妻 愉快 的 玩耍 等等
你 迈真忙 和 猫 女 离了婚 马上 找到 前女友 隔 几个 月 和 另 一个 女 人造 娃黛比 给 他 生娃 他 和 前妻 愉快 的 玩耍 等等	精力旺盛 你 不服 不行 啊 屌 大活 好 咋 地
精力旺盛 你 不服 不行 啊 屌 大活 好 咋 地	可怕
好像 她 一笔带过 恐怕 为了 尊重 迈 的 隐私 故意 不多 提 但是 事情 确实 是 发生 了	看来 这 妹子 还 有点 节操 忘 了 在 哪 看 的 猫 女 提过 她 和 迈 的 船事 在 椅子 上 迈 的 娇喘 啥 的
看来 这 妹子 还 有点 节操 忘 了 在 哪 看 的 猫 女 提过 她 和 迈 的 船事 在 椅子 上 迈 的 娇喘 啥 的	在 椅子 上 ? 我 倒 听说 是 在 沙发 上
在 椅子 上 ? 我 倒 听说 是 在 沙发 上	感觉 来 了 想 在 哪 做 就 在 哪 做
为什么 要 拍卖 迈 的 私人物品	我们 也 想 知道
我们 也 想 知道	是 啊 怎么 迈 的 东西 都 成为 他们 私人物品 了 想 拍卖 就 拍卖
说实话 并 不 漂亮 身材 也 一般 远 没 小时候 好看	可是 我 觉得 有事没事 去 评价 女孩子 长得 好不好 看 身材 好不好 挺 的
可是 我 觉得 有事没事 去 评价 女孩子 长得 好不好 看 身材 好不好 挺 的	哈哈 如果 我 夸 她 漂亮 你 还 会 这么 说 吗
我 的 男神 和 女神 跟 你 一样 他们 都 是 降落 人间 的 天使	那 我们 三个 就是 一样 的 喽
那 我们 三个 就是 一样 的 喽	英雄所见略同
僵尸 粉	相相伤
相相伤	猝不及防 啊
猝不及防 啊	不怪 你 不怪 你 别 内疚 啊 我 和 我 的 男友 祝你们 俩
不怪 你 不怪 你 别 内疚 啊 我 和 我 的 男友 祝你们 俩	可以 可以
我 连 五十 都 不到 亲	说 的 也 是 我 得 乐观
说 的 也 是 我 得 乐观	谢谢 亲
谢谢 亲	不 客气 咱们 都 是 迈克尔 的 饭
不 客气 咱们 都 是 迈克尔 的 饭	哈哈哈哈
你 一夜 涨 一百多个 僵尸 粉 就 上 三百个 粉丝 了 我 两百 还 不到 呢	你加 我 了 没 帮 我 个 忙 帮 我 把 我 的 日 直接 个 完整 的 平 发给 迈克尔 杰克逊 中国 网 拜托 了 谢谢
你加 我 了 没 帮 我 个 忙 帮 我 把 我 的 日 直接 个 完整 的 平 发给 迈克尔 杰克逊 中国 网 拜托 了 谢谢	看 私信 啦
你 就 值 五块 钱	你 太 低 了 哎
你 太 低 了 哎	其实 只要 买主 合适 我 还 能 打折 的
世界 上 最贵 的 要么 无价 要么 免费 比如说 我	你 两者 都 不是 你 属于 免费 的 还 没人要 的 那种
你 两者 都 不是 你 属于 免费 的 还 没人要 的 那种	我 对于 没人要 的 结果 很 满意
心中 有 阳光 处处 是 温暖 然 心中 桃花开 满满 都 是 伤	为什么 会 这样
为什么 会 这样	因为 我 对 这片 土地 爱得 深层
因为 我 对 这片 土地 爱得 深层	我 就 想 对 你 说 喜儿 我要 发财
我 就 想 对 你 说 喜儿 我要 发财	共勉 发财 是 迟早 的 事 哈哈哈
共勉 发财 是 迟早 的 事 哈哈哈	你 的 名字 倒 过来 说 感觉 又 像是 在 祝福 你 可 我 是 想 说 自己 的
你 的 名字 倒 过来 说 感觉 又 像是 在 祝福 你 可 我 是 想 说 自己 的	哈哈
你 选 的 那个	哈哈哈
哈哈哈	还 笑
还 笑	你 就 运气 好
原来 就是 你 小子 啊	最近 我 再 多一点 这辈子
最近 我 再 多一点 这辈子	去 去 去 这辈子 都 说 了 你 没救 了
他 深陷 这个 死循环 了	我 也 要 写 一下 这辈子 了
我 也 要 写 一下 这辈子 了	你 这辈子 你 这辈子 就 这样 了
养 我	养不起
养不起	养不起 挣钱 啊
养不起 挣钱 啊	挣 不到
挣 不到	卖身
卖身	这 其实 就是 我 梦想 的 职业 求 推荐
是不是 不管 怎么样 还 都 是 我养 你	到处 撩能 不能 专心 点
到处 撩能 不能 专心 点	艾玛 说 的 你 在家 等 我 的
艾玛 说 的 你 在家 等 我 的	都 等 一天 了
哦 擦 嘞	还 不 睡
还 不 睡	马上 马上 刷 完微博 就 去 睡觉
马上 马上 刷 完微博 就 去 睡觉	好 梦 啦
好 梦 啦	晚安
排骨 教主 和 西瓜 还有 王胖子 是 特别 特别 要 好 的 兄弟 俗称 王胖 排瓜 但是 排骨 不 喜欢 和 人组	排骨 教主 目前 是 骨哥 骨妹 一起 天天 发狗 粮
排骨 教主 目前 是 骨哥 骨妹 一起 天天 发狗 粮	官方 日常 狗 粮 对 了 排骨 小号 也 就是 精分 骨妹 的 微博是 排骨 节操 收割机
对 了 你 加 的 排骨 哪个 群 啊	一个 没有 排骨 的 群 还有 有 排骨 的 微博群 啊
一个 没有 排骨 的 群 还有 有 排骨 的 微博群 啊	我加 的 是 排骨 神群 六 分部 果园 你 呢 排骨 的 群太多 了 我 知道
我加 的 是 排骨 神群 六 分部 果园 你 呢 排骨 的 群太多 了 我 知道	我加 的 就是 一个 粉丝 自己 的 群 没有 排骨 有 排骨 的 那些 官方 群 我 没加
想 起来 了 我 室友 提 过	就是 票 和 我 都 在 南京
就是 票 和 我 都 在 南京	噗 还 都 在 南京
另 一个 人 是不是 我	不是 另 一个 皮下
不是 另 一个 皮下	扎心 了
扎心 了	没 办法 不想 说谎 早点 睡 吧 晚安
活捉 又 换 头像	我 没有 换 呀
我 没有 换 呀	可能 系统 不 对 你 这个 和 聊天 时候 的 不 一样 了
可能 系统 不 对 你 这个 和 聊天 时候 的 不 一样 了	不是 二狗 么 是 绿色 的 ?
不是 二狗 么 是 绿色 的 ?	不是 聊天 那里 是 执明 这里 是 表情 包
不是 聊天 那里 是 执明 这里 是 表情 包	哈哈哈 哈哈哈 嗝
手机 差点 摔 出去	不 好看 吗
不 好看 吗	不是 不是 我 说 最后 一张
不是 不是 我 说 最后 一张	最后 一张 最 好看
杀人 了 这个 最后 一张	好看 吗
好看 吗	要 吐 了
能 把 手上 那 块 牌子 放 下来 不	跟 智障 一样
跟 智障 一样	哈哈哈 声音 依然 是 关注点
冰糖 雪梨 水	昨天 的 澳门 豆捞 你好
昨天 的 澳门 豆捞 你好	哈哈哈 哈哈哈 下次 可能 是 其他 水 或 捞 了 晚安 早睡
哈哈哈 哈哈哈 下次 可能 是 其他 水 或 捞 了 晚安 早睡	晚安
刚刚 强迫 自己 放下 对 火锅 的 不 正当 想法	别 放下 了 明天 就 去 吧
别 放下 了 明天 就 去 吧	现在 就 想 去
现在 就 想 去	我 也 你 知道 我 刚才 搜图 的 时候 的 那种 感觉 吗
我 也 你 知道 我 刚才 搜图 的 时候 的 那种 感觉 吗	一定 要 互相 伤害 芝士 得利 吗
一定 要 互相 伤害 芝士 得利 吗	哈哈哈 哈哈哈 芝士 就是 力量 啊
没 欲望 怎么办 你 说 怎么办 啊 怎么办 哇 前方 刚好 十五 字	欲 欲望 ? 小 清新 不好过 啊
欲 欲望 ? 小 清新 不好过 啊	小 清新 清新 有人 说 你 不行 欸 你 说 怎么办
小 清新 清新 有人 说 你 不行 欸 你 说 怎么办	! ? 噢 不好意思 啊 我 以为 你 是 攻
! ? 噢 不好意思 啊 我 以为 你 是 攻	你 套路 我 以后 不水 你 了
你 套路 我 以后 不水 你 了	别 啊 大佬
胡萝卜	我 发现 只 从 遇到 一姐 后 总会 遇到 不少 胡萝卜
我 发现 只 从 遇到 一姐 后 总会 遇到 不少 胡萝卜	看到 胡萝卜 就 会 想到 一姐
看到 胡萝卜 就 会 想到 一姐	嗯 嗯 对 的
爆照 吗 这 是	没错 爆照 了
没错 爆照 了	正脸 呢
正脸 呢	下次 给 你 看
下次 给 你 看	好 呀 好 呀
所以 你 看到 了 吗	没有
没有	我 也 没有
我 也 没有	哎
手速 我 也 是 賊 巴 佩服 的 群里 那么 多人 每 一个 人 拼得 过 他	丈母娘 你 手癌 了 没 不是 每
丈母娘 你 手癌 了 没 不是 每	哈哈哈哈 哈哈哈 我 老 了
我 的 天 在 首页 啊 年 大发 啊	你 不 吐 槽 我 头像 不 舒服
你 不 吐 槽 我 头像 不 舒服	我 忍不住 啊
厉害 了 虞祎杰	努努 啊 还是 你 最好 了 爱 你
努努 啊 还是 你 最好 了 爱 你	别 叫 怒 努 了 叫 阿爸 好 了 亲切 得 很 呐
早点 休息	嗯 嗯
嗯 嗯	晚安 了
晚安 了	晚安
我 喜欢 你 不 需要 你 知道 不 需要 我 回味	噗 哈哈哈哈 哈哈哈哈
噗 哈哈哈哈 哈哈哈哈	图片 评论
他 是 我 老公	你 老公 不是 佐助 吗
你 老公 不是 佐助 吗	我 有 很多 老公
还有 我 小天使	艾伦
艾伦	多 看看 兵长 心情 就 好 了
多 看看 兵长 心情 就 好 了	刚看 完 第一集 恶心 死 了
可恶 我 没有	以后 还会 有 很多 机会 的 啦 总有 一次 会 是 幸运 的 笔芯
以后 还会 有 很多 机会 的 啦 总有 一次 会 是 幸运 的 笔芯	我 知道 我 就 没想 过
后 半句 叉 掉	好 昨晚 盗 的 图
好 昨晚 盗 的 图	低调 低调
画风 突变	那 现在 是 啥 画风 呢
那 现在 是 啥 画风 呢	暖 暖 小编 有点 可爱 了
叮嘱 大 师兄 多吃点 鱼 吃 鱼变 聪明	师兄 需要 明目
师兄 需要 明目	对 对 对
小编 好 可爱	小编 是 吃 可爱多 长大 的
小编 是 吃 可爱多 长大 的	哈哈哈 小编 我 要 粉 你 哈哈哈哈 啊哈
哈哈哈 小编 我 要 粉 你 哈哈哈哈 啊哈	不是 早就 终于 找到 小编 了 嘛 应该 就是 你 说 的 呀 小编 应该 没 记错 呀
好看	好 吧 好 吧 下次 有 什么 需要 的 电视 可以 找 我 哦
好 吧 好 吧 下次 有 什么 需要 的 电视 可以 找 我 哦	你 是 卖 视频 的 对 吧
你 怎么 像 刚 知道 一样 之前 跟 你 说 过 啊 渣 反 也 要 做 还有 以及 我 给 你 推 的 帝王 攻略	这 不 确定 时间 了 嘛 渣 反 我 看不下去 诶
这 不 确定 时间 了 嘛 渣 反 我 看不下去 诶	我 看 完 了 但是 觉得 就 那样 还是 魔 道 好看
我 看 完 了 但是 觉得 就 那样 还是 魔 道 好看	渣 反先火 的 尝试 了 两次 都 没 看 下去
白 呢	白在 这儿
白在 这儿	他 有 泪 痣 啊
他 有 泪 痣 啊	呀呀
己经 听 过 了 傲娇 咆哮 的 白 处长 萌翻 了	星星 春妹 在 超级 话题 里浪 呀 浪
星星 春妹 在 超级 话题 里浪 呀 浪	我己 经 回复 了 话 说 徒手 倒立 很难 的 厉害 了
我己 经 回复 了 话 说 徒手 倒立 很难 的 厉害 了	超级 话题 里 置顶 第一条 也 是 他
超级 话题 里 置顶 第一条 也 是 他	是 的 阿春 难得 啊
是 的 阿春 难得 啊	哈哈 这 几天 他 可浪 啦
哈哈 这 几天 他 可浪 啦	怎么 呢 是不是 有 什么 开心 的 事
怎么 呢 是不是 有 什么 开心 的 事	有 时间 浪 了 吧
在 哪 可以 找到	需要 微盘 下载 吗
需要 微盘 下载 吗	谢谢
谢谢	我 最 喜欢 白 大大 了
什么 软件 儿 做 的 看来看去 还是 我 那 张 最 好看 了	玩图 软件 的 名字 我 也 觉得 你 那 张 最 好看
玩图 软件 的 名字 我 也 觉得 你 那 张 最 好看	给 我 也 做 一张 啊 我 去 找 找 图 私聊 你
给 我 也 做 一张 啊 我 去 找 找 图 私聊 你	好 的
我要 吃	来 中间 那盆 都 给 你
来 中间 那盆 都 给 你	寄给 我 好 吗
寄给 我 好 吗	等 世乒赛 结束 我 多 做点 其他 的 然后 抽个 奖 等 我
等 世乒赛 结束 我 多 做点 其他 的 然后 抽个 奖 等 我	抽奖 你 觉得 我 这种 非洲人 能 中 直接 黑幕 我 一份 套餐
抽奖 你 觉得 我 这种 非洲人 能 中 直接 黑幕 我 一份 套餐	晚安
晚安	晚安 傻琪
嫁给 我 吧	你 先 出疆 咱们 再谈
你 先 出疆 咱们 再谈	扎心
我要 娶 你 大饼	你 还是 娶 我 大爷 吧
你 还是 娶 我 大爷 吧	你 大爷 是 龙 么
你 大爷 是 龙 么	我 大爷 是
微博买 的 ?	对 支付宝 也 可以
对 支付宝 也 可以	你 看 了 ?
你 看 了 ?	看 了 今天下午 看 的 我 觉得 还 可以 给 . 分
看 了 今天下午 看 的 我 觉得 还 可以 给 . 分	我 也 去 看看
我 也 去 看看	推荐
厉害 了	谢谢 夸奖
谢谢 夸奖	厉害 了 小辣鸡
厉害 了 小辣鸡	谢谢 大辣鸡
我 也 是 这样	没 办法 咱们 美的 人 都 这样
没 办法 咱们 美的 人 都 这样	哈哈 这个 行
有人 跟 你 表白 没	老 妹儿 你 也 要 加紧 啊 喜欢 的 撩起 走
老 妹儿 你 也 要 加紧 啊 喜欢 的 撩起 走	喜欢 的 不 喜欢 我 没 喜欢 我 的
能 同时 安装 两个 吗	不太 清楚 哎
不太 清楚 哎	我 居然 真的 去 百度 下 了 一个
我 居然 真的 去 百度 下 了 一个	哈哈 有毒
生日快乐	清明
清明	哈哈 我 也 赶上 过
要 幸福 呦	不 知道 会 有 什么 结局
不 知道 会 有 什么 结局	别想 辣 么 多 啦
恭喜 啊	不出意外 快分 了 他 不 上心 我 累 了
不出意外 快分 了 他 不 上心 我 累 了	这 也 太快 了 吧
这 也 太快 了 吧	不 知道 很 喜欢 他 但是 我 不 知道 他 怎么 想 的
真的 同步 别 吓 我	假 的 啊 愚人节 消息
假 的 啊 愚人节 消息	我刚 看到 吓 了 跳 一看 日期 就
啧啧 啧	越来越 帅 了 这些 小伙子
越来越 帅 了 这些 小伙子	怒 舔
怒 舔	第四张 简直 是 暴击
第四张 简直 是 暴击	实力 演绎 安静 的 美男子
实力 演绎 安静 的 美男子	小伙子 里面 我 最 喜欢 磊磊 和昊然 底迪
小伙子 里面 我 最 喜欢 磊磊 和昊然 底迪	磊磊 看琅 琊 榜 的 时候 挺 喜欢 的 后来 发现 他 太 瘦 了 啊
磊磊 看琅 琊 榜 的 时候 挺 喜欢 的 后来 发现 他 太 瘦 了 啊	不 影响 他 的 帅 看 我 安利 给 你
哇博	太帅 了 新剧 今天 进 剧组 好久没 看到 等等 的 现代 剧 了 激动
太帅 了 新剧 今天 进 剧组 好久没 看到 等等 的 现代 剧 了 激动	据说 男主 这个 人设 很 苏 很 适合 等等
据说 男主 这个 人设 很 苏 很 适合 等等	酒吧 的 老板
酒吧 的 老板	哈哈 我 还 没有 看过 两天 补 回来
今天 又 觉得 吴磊 很 可爱	有病
有病	你 咋 知道 我 刚发 了 评论
你 咋 知道 我 刚发 了 评论	系统
渊博 评论 里 有人 开车	我 只是 实诚
我 只是 实诚	那 车速 太快 了
那 车速 太快 了	图片 评论
图片 评论	图片 评论
图片 评论	好好 的 先生 为什么 突然 开始 斗图
好好 的 先生 为什么 突然 开始 斗图	我 也 不 知道
感觉 很多 文人 都 喜欢 叫 先生 夫人 特别 有 礼貌 的 样子	嗯 嗯 特别 婉转 含蓄 又 很 爱意 这 是 我 先生 这 是 我 夫人
嗯 嗯 特别 婉转 含蓄 又 很 爱意 这 是 我 先生 这 是 我 夫人	鱼蛋 是 你 先生 花花 也 是 你 先生
这 是 买 了 数位 板 嘛	没用 的 无印 的 软 毛笔 写 的
没用 的 无印 的 软 毛笔 写 的	好像 那种 电脑 发出 来 的
小满字 越来越 好 了 要 不要 转发 写 呀	还是 觉得 有些 字 好 难看
还是 觉得 有些 字 好 难看	唔 那 就 再 练练
炸酱面 就 寡是 面 跟 酱 啊	里面 会 有 肉 一般 份 糖醋 肉 搭配 但 我 喜欢 配辣 的 海鲜 面 因为 只 吃 炸酱面 太腻 了
里面 会 有 肉 一般 份 糖醋 肉 搭配 但 我 喜欢 配辣 的 海鲜 面 因为 只 吃 炸酱面 太腻 了	哦 哦 感觉 韩国 人 都 很 喜欢 吃 炸酱面
哦 哦 感觉 韩国 人 都 很 喜欢 吃 炸酱面	韩国 炸酱面 是 真的 好吃 我 心中 的 韩国 食物
又 是 一个 考研 的 娃 吗	嗯 呐 录取 啦
嗯 呐 录取 啦	你 考 什么 专业 的
你 考 什么 专业 的	学科 教学 英语
学科 教学 英语	为什么 就 没有 科研型 的 数学 物理 的 人 呢 忧伤 微博刷 到 的 不是 小学 教育 就是 学科 教育
快 吃 快 吃 吃 胖点	辉哥 你 变 了
辉哥 你 变 了	我 咋 咯
我 咋 咯	变得 跟 毛鑫 一个 德性
变得 跟 毛鑫 一个 德性	物以类聚 人以群分 想必 毛鑫鑫 对 这句 话 感触 颇 多 啊
怎么 又 去 金华 了	下次 来 就是 来看 你 了
下次 来 就是 来看 你 了	好 啊 哈哈
什么 叫 德性	你 懂
你 懂	而且 这个 毛鑫 是 个 负心汉 下次 打毛鑫鑫
而且 这个 毛鑫 是 个 负心汉 下次 打毛鑫鑫	不 我 觉得 打毛鑫 挺 好 赵伟云 每次 叫 你 听 着 就 像 毛鑫
快 吃 快 吃 吃 胖点	你 滚 我 不 拦 你
你 滚 我 不 拦 你	我 不 滚 我 不 滚
我 不 滚 我 不 滚	凑 不要脸
母爱 又 泛滥 了	可是 我 想 说 的 是 你 没 抓住 我 的 重点
可是 我 想 说 的 是 你 没 抓住 我 的 重点	我 当然 知道 你 想 说 啥 啦
我 当然 知道 你 想 说 啥 啦	厉害 了 辉哥
偶像 忙里偷闲 稳 的 吖 批	等你来了 带 你 一起 哈皮
等你来了 带 你 一起 哈皮	杭州 绿城
杭州 绿城	不是 降级 了 么
不是 降级 了 么	中甲 一样 踢 呗
中甲 一样 踢 呗	稳 老哥 忠实 球迷
稳 老哥 忠实 球迷	聚聚
聚聚	稳 老哥
二鸣 我 觉得 你 像 曾诚 真的 超级 像	我 觉得 这 评价 很 高
我 觉得 这 评价 很 高	你 看 那个 跑 起来 那张 超像 ! 当然 毕竟 国 足 金城武 .
你 看 那个 跑 起来 那张 超像 ! 当然 毕竟 国 足 金城武 .	膨胀 了 膨胀 了
我 感兴趣	要么
要么	去 不了
建议 你 去 罗志祥 吧 转 特别 快	块钱 人家 都 不 愿意 买 哈哈哈哈
块钱 人家 都 不 愿意 买 哈哈哈哈	太惨 了 朱碧石 不是 挺棒 的 么
太惨 了 朱碧石 不是 挺棒 的 么	不 知道 耶
不要 对 我 没有 抵抗力	不会 的 哈哈哈哈
不会 的 哈哈哈哈	你 应该 说 你 做 不到
我 是 大侠 噢	我 看 啦 他 说 马上 就要 播出 了 好 期待
我 看 啦 他 说 马上 就要 播出 了 好 期待	我查 了 一下 抚顺 的 还是 天蝎座
我查 了 一下 抚顺 的 还是 天蝎座	天蝎座 怎么 啦
天蝎座 怎么 啦	和 我 绝配
我姓 柯工藤新 一 的 柯	不喊点 开
不喊点 开	不是 关于 电视剧 的 这个 快 问 快答 我 基本 懂 了
什么 左手 右手	就是 男生 自己 解决 的 时候 用 左手 还是 右手
就是 男生 自己 解决 的 时候 用 左手 还是 右手	好 吧 懂 了 谢谢
只想 问 云朵 是 谁	海洋 还有 一部 剧 那部剧 的 女主 谭松韵 演哒
海洋 还有 一部 剧 那部剧 的 女主 谭松韵 演哒	哦哦哦 哦 酱 啊
云朵 是 谁	浪花 一朵朵 中 的 谭松韵
浪花 一朵朵 中 的 谭松韵	好 的
一起 同过 窗 那 钟白 还是 余皓 庞瀚辰 粉丝 汇大爱 我辰哥 庞瀚辰 庞瀚辰 一起 同过 窗 庞瀚辰	海洋 另 一部 戏 的 女主
海洋 另 一部 戏 的 女主	是 叫 啥 浪花 一朵朵 嘛
我 告诉 你 开 了 之后 你 要是 还 那么 傲娇 的话 我会 打 你 的	那 我 打 你
那 我 打 你	你 这 是 要 上天 啊 有 你 这么 拽 的 官博嘛 啊 怼 粉丝 怼 成 什么样 了 都
就 不 帮 你	很 有种 哦
很 有种 哦	图片 评论
这个 可以 有 叫 不 叫 啊 活 在 异次元 的 竹子 当年 都 没 觉得 浊酒 惊弦 哈哈哈 哈哈哈 好好 好 我 吃 杰西卡 呵呵 呵 妈妈 这个 甜	想 吃 哪里 都 有 糖
想 吃 哪里 都 有 糖	已经 是 很 服气 了
亲自 下河 知 深浅	大 晚上 的 还 不 挺 瞌睡
大 晚上 的 还 不 挺 瞌睡	我 住院 的 人
么 么 哒 我 已经 找到 人 了 就是 给 你 拍 的 那个 姐姐	可以 的 你 拍 什么 风格
可以 的 你 拍 什么 风格	小 清新 点 的 吧 哈哈哈 我要 等 高考 完 了 再 去
小 清新 点 的 吧 哈哈哈 我要 等 高考 完 了 再 去	哈哈哈 还有 这么久 期待 我 的 天使 拍 出来 的 样子
哈哈哈 还有 这么久 期待 我 的 天使 拍 出来 的 样子	主要 是 现在 没 时间 嘛
我 看到 了 两遍 哟 哈哈哈哈	哈哈哈 等 我 回去 了 约 你
哈哈哈 等 我 回去 了 约 你	好 的
你 要 回归 微博 了 吗	哈哈哈 我 这 叫 啥 回归 也 就 挪个 地方 给 你们 几个 看
哈哈哈 我 这 叫 啥 回归 也 就 挪个 地方 给 你们 几个 看	哈哈 你 还 大房 二房 轮流 宠
哈哈 你 还 大房 二房 轮流 宠	过段时间 就 腻 了 所以 就 匿 了
呆萝莉 越来越 小 了 身体 很 重要 快快 好 起来	恩恩 ! 我要 做 一只 瘦瘦的 又 健康 的 呆 小
恩恩 ! 我要 做 一只 瘦瘦的 又 健康 的 呆 小	嗯 已经 很瘦 啦 稍 长点 肉 肉 也 很 好 呀
嗯 已经 很瘦 啦 稍 长点 肉 肉 也 很 好 呀	我 发现 还是 瘦 了 穿衣服 好看 咱俩 应该 我 把 你 带 瘦 夏天 来 了
我 发现 还是 瘦 了 穿衣服 好看 咱俩 应该 我 把 你 带 瘦 夏天 来 了	哈哈 如此 甚 好 早点 睡觉 养颜 嘿嘿 晚安
哈哈 如此 甚 好 早点 睡觉 养颜 嘿嘿 晚安	早安 了 都
这 体重	没事 矮
没事 矮	多高 啊
多高 啊	不到 再 问 自杀
不到 再 问 自杀	多高 啊
多高 啊	到底 多高 啊
到底 多高 啊	你 猜 吧 多 思考 有助于 大脑
你 猜 吧 多 思考 有助于 大脑	左右
啊 哦 大四 狗	毕设 搞 死 我
毕设 搞 死 我	加油 搞 死 他
加油 搞 死 他	学姐 去 哪 工作 呀
学姐 去 哪 工作 呀	学姐 现在 还 没签 呢 还 在 流浪
学姐 现在 还 没签 呢 还 在 流浪	还 没签 啊
还 没签 啊	恩 情况 特殊
恩 情况 特殊	那 学姐 去 那类 公司 啊
那 学姐 去 那类 公司 啊	比较稳定 的
比较稳定 的	设计 吗
设计 吗	我 经管 的
我 经管 的	祝你幸福
祝你幸福	不许 歧视 我们 经管
不许 歧视 我们 经管	我 一直 央视
网慢 电脑 慢	舍友 就 没事
舍友 就 没事	恩 抱抱
我 现在 还 不 知道 怎么 实证	我 也 不 知道 我 需要 指导书 一步步 教 我
我 也 不 知道 我 需要 指导书 一步步 教 我	有 指导书 麻烦 电邮 我 一份 谢谢
有 指导书 麻烦 电邮 我 一份 谢谢	我 去 晨光 下 了 教程 当低 配版 指导书 你 需要 吗
我 去 晨光 下 了 教程 当低 配版 指导书 你 需要 吗	晚上 发 你
加油	恩哭 瞎
恩哭 瞎	摸摸头 摸摸头 总会 好 的
摸摸头 摸摸头 总会 好 的	恩 最后 一 蹬腿 了
卧槽 这 是 喵 酱 骗人 的 吧	骗 妮子 的
骗 妮子 的	梨子 那么 喜欢 你 你 为什么 要 骗 她
和 妹控 在 实验室 讨论 了 半天 这个 皂片 . 女生 都 是 中分 酷酷 的	你 俩 一个 实验室 的
你 俩 一个 实验室 的	哈哈哈 是
哦 我 的 天	你 这句 话 有 你 表情 的 画面感
你 这句 话 有 你 表情 的 画面感	哈哈哈 就是 这样
我 猜 你 的 表情 肯定 被 修 了 好 自然 啊	我 一般 都 是 抿嘴 严肃 的 那种 笑 这个 咧嘴 咧 的 真是 太不容易 了 还好 摄影师 超 耐心 一直 开玩笑 让 我 放松 来 着
我 一般 都 是 抿嘴 严肃 的 那种 笑 这个 咧嘴 咧 的 真是 太不容易 了 还好 摄影师 超 耐心 一直 开玩笑 让 我 放松 来 着	特别 有 女强人 的 感觉
特别 有 女强人 的 感觉	好羡慕 女强人
现在 才 有 学姐 范儿 哈哈	正襟危坐 的 我
正襟危坐 的 我	哈哈 可萌 了
哈哈 可萌 了	扑上去
一瞬间 长大 了 的 感觉	舍不得 我 心爱 的 日系 幼稚 风
舍不得 我 心爱 的 日系 幼稚 风	哈哈哈哈
莫初 我 感觉 自己 瞬间 画风 不 一样 了 大概 这是 我姐	还是 美 啊
还是 美 啊	修图 师傅 腻害
修图 师傅 腻害	主要 还是 底子 好人 漂亮
主要 还是 底子 好人 漂亮	靴靴
靴靴	这个 证件照 真的 是 见 过 最美 的 了
这个 证件照 真的 是 见 过 最美 的 了	别 看到 我 本人 觉得 太 欺诈
别 看到 我 本人 觉得 太 欺诈	觉得
你 的 意思 是 本人 又 美 又 萌 吗	本人 完全 没 这种 可靠 的 样子 我 都 怕 面试 觉得 我 身体 不好
本人 完全 没 这种 可靠 的 样子 我 都 怕 面试 觉得 我 身体 不好	很瘦
卧槽 神 马哈	长发 腻 了 换个 发型
长发 腻 了 换个 发型	真是 任性 我 还 在 犹豫 染个 什么 色 呢
真是 任性 我 还 在 犹豫 染个 什么 色 呢	看来 你 也 厌倦 了 黄毛
看来 你 也 厌倦 了 黄毛	我 在 纠结 呢 是 染黑 的 还是 染棕 的 快 帮 我 想想
我 在 纠结 呢 是 染黑 的 还是 染棕 的 快 帮 我 想想	黑 的 没意思 棕 的 吧
可以 很姚	小弟 年纪 轻
小弟 年纪 轻	嘿嘿嘿
好 厉害 被 英皇 录取 了 吗	寒假 去 面试 亲爱 的
寒假 去 面试 亲爱 的	真棒 加油 啊
真棒 加油 啊	我会 的
威廉 陈伟霆 我 在 学 六级	什么 六级
什么 六级	英语六级
英语六级	哦 哈哈 加油
哦 哈哈 加油	好 哒
太阳 的 后裔 里面 的 插曲	特别 喜欢 太阳 后裔 的 插曲
特别 喜欢 太阳 后裔 的 插曲	我 也 是 每 一 首都 喜欢 还有 中文版 也好 听
第七 张是 什么 时候	第二季 收官 颁奖礼 的 时候
第二季 收官 颁奖礼 的 时候	没播 呢 吧
没播 呢 吧	嗯 还 没播 这 是 现场 返图
嗯 还 没播 这 是 现场 返图	嗯 很 美好
嗯 很 美好	对 的
小白辣 么 暖	还 辣 么 萌
还 辣 么 萌	还 辣 么 帅 辣 么 高
还 辣 么 帅 辣 么 高	还 辣 么 单纯 不 做作
来 吧 宝贝	互相 伤害 吗
互相 伤害 吗	要 不要
要 不要	丑拒
学会 忘记 吧	要 过 得 更好
要 过 得 更好	必须 的
必须 的	不要 这样 笑 很 猥琐
不要 这样 笑 很 猥琐	呵呵 萨牙玛 在 干吗
呵呵 萨牙玛 在 干吗	看电视
刘福丽 昨晚 的 感觉 好爽 啊	不 知道 你 在 说 什么 不 明白
不 知道 你 在 说 什么 不 明白	打电话 给 你 的 时候 啊
打电话 给 你 的 时候 啊	你 做梦 了 我 昨晚 很 早就 睡 了
你 做梦 了 我 昨晚 很 早就 睡 了	要 不要 我 把 通话记录 微博
要 不要 我 把 通话记录 微博	好 吧 我 被 你 打败 了 无语 了
跟 谁 聊 的 天	想 知道 吗
想 知道 吗	不然 我 问 你 干嘛
不然 我 问 你 干嘛	那好 吧 我 就 勉强 告诉 你 吧
那好 吧 我 就 勉强 告诉 你 吧	那好 吧 那 我 就 勉强 听 吧
那好 吧 那 我 就 勉强 听 吧	明明 就 告诉 你 了 还 在 这里 装
明明 就 告诉 你 了 还 在 这里 装	现在 的 人 要 学会 装懂
现在 的 人 要 学会 装懂	学会 装 了 才 知道 别人 是 怎么 装 的
学会 装 了 才 知道 别人 是 怎么 装 的	太会装 了 可惜 我 不会 啊
什么 花 好看	如果 花不修 图 都 不能 看 你 信 么
如果 花不修 图 都 不能 看 你 信 么	信 如果 不 调 一下 感觉 看不下去
信 如果 不 调 一下 感觉 看不下去	是 的
是 的	就是 这样 的
渍 渍 渍	难道 一个 不够
难道 一个 不够	不够
不够	给你个 吧 我 好 吧
给你个 吧 我 好 吧	谢谢 大佬
美美 哒 和 我 一样 美 嘿嘿	自恋 到 一种 地步 也 是 阔 怕
自恋 到 一种 地步 也 是 阔 怕	哪有 本来 就是 嘛 人家 是 祖国 的 花朵
哪有 本来 就是 嘛 人家 是 祖国 的 花朵	真替 祖国 悲伤
明天 清明节	假期 就要 结束 了
假期 就要 结束 了	明天 最后 一天
明天 最后 一天	时间 过得 太快 还 没 反应 过来 假期 就 没有 了
时间 过得 太快 还 没 反应 过来 假期 就 没有 了	同感 摄影 不知不觉 就 过去 了
新 的 一天 开始 了	开始 一段 新 的 旅程
开始 一段 新 的 旅程	对 的 马上 出发
对 的 马上 出发	相信 今天 又 是 开心 快乐 的 一天
来 了	么 么 哒
么 么 哒	哎 心不甘 情不愿 的
来晚 了 棒棒 棒 重要 的 事 说 三遍	么 么 哒 提点 意见 呗
么 么 哒 提点 意见 呗	花 不是 很 懂 傻傻 分不清 除了 油菜花
花 不是 很 懂 傻傻 分不清 除了 油菜花	哈哈 在 这点 上 我 和 你 一样 傻傻 分不清楚
哈哈 在 这点 上 我 和 你 一样 傻傻 分不清楚	梨花 海棠花 桃花
梨花 海棠花 桃花	完全 懵圈
完全 懵圈	晚安
如果 吧 水印 去掉 就 好 了	昨天 手癌 调 的 给 忘 换回来 了
昨天 手癌 调 的 给 忘 换回来 了	放到 中间 下面
放到 中间 下面	好 的 一会儿 就 换 谢谢
花儿 不错	耿哥 知道 我 等 你 好久 了 吗
耿哥 知道 我 等 你 好久 了 吗	你 手机 拍 的 不错
你 手机 拍 的 不错	也 是 谢谢 咯 我会 努力 努力
也 是 谢谢 咯 我会 努力 努力	嗯 加油
嗯 加油	会 的
棒棒 的 某	回来 奖励 我 不过 再 强调 一遍 我 很 聪明 的
回来 奖励 我 不过 再 强调 一遍 我 很 聪明 的	奖励 你 一个 聪明 的 漂亮 的 本 宝宝
奖励 你 一个 聪明 的 漂亮 的 本 宝宝	真是 不想 颠 你
真是 不想 颠 你	哈哈哈 那么 聪明 的 本 宝宝
哈哈哈 那么 聪明 的 本 宝宝	只想 说 你
只想 说 你	你 才
你 才	伤心 明明 这么 聪明 的 一个 人
伤心 明明 这么 聪明 的 一个 人	并 不是 哦
并 不是 哦	哪有 明明 就是
哪有 明明 就是	明明 就 不是 好 吗
明明 就 不是 好 吗	明明 就是
今天 我 又 来 了	耿哥 下午 好
耿哥 下午 好	好 愚人节 快乐
好 愚人节 快乐	愚人节 快乐 呀
图黑	之后 会 注意 的 谢谢 耿哥
之后 会 注意 的 谢谢 耿哥	一块 加油
一块 加油	嗯 嗯 加油
第一张 还 可以	也 是 我 最 满意 的
也 是 我 最 满意 的	然而 其他 的 都 欠佳
然而 其他 的 都 欠佳	之后 改进
之后 改进	可以 可以 等 你 改进 给 我 拍
可以 可以 等 你 改进 给 我 拍	好勒好 勒
可以 哦 等 放假 我来 做 模特 拍 天生丽质 的 我 哈哈	噗 天生丽质 没 看 出来
噗 天生丽质 没 看 出来	哈哈 怎么 能 这样 呢
哈哈 怎么 能 这样 呢	实话实说
再说 我 这么 温柔	你 说谎 良心 都 不痛 的 吗
你 说谎 良心 都 不痛 的 吗	老张 别搞 事
老张 别搞 事	那 我 就 不 拆穿 你 了
第一张 说实话 真的 吓 到 我 了 简直 神作 无论是 色调 还是 构图 还是 女孩 表情 都 很 到位 此外 桃花 人物 等 整个 画面 都 粉嫩 通透 让 人 看 了 舒心 原谅 接下去 我 的 直言 第二张 开始 感觉 水平 在 降低 了 你 应该 对 画面 整体 用 了 类似 古风 的 滤镜 说实话 不怎么 合适 桃花 拍 的 是 春天 素材 画风 也 是 暖色调 的 更 应该	哈哈 这是 海棠花
哈哈 这是 海棠花	谢谢 提醒 原谅 我盲 各种 相似 的 东西 总是 傻傻 分不清
谢谢 提醒 原谅 我盲 各种 相似 的 东西 总是 傻傻 分不清	李花 樱花 桃花 杏花 梨花 很 容易 混 的
李花 樱花 桃花 杏花 梨花 很 容易 混 的	在 我 眼里 一样 了 都 是 白里透红 的 小花
在 我 眼里 一样 了 都 是 白里透红 的 小花	哈哈
就 喜欢 你 直言 之后 我会 注意 的 谢谢 么 么 哒 朋友 说 看着 我 紧张	害怕 我 还 以为 要 被 打 了 喜欢 正反 都 说 这样 比较 稳得 综合 评价 嘻嘻
害怕 我 还 以为 要 被 打 了 喜欢 正反 都 说 这样 比较 稳得 综合 评价 嘻嘻	这样 很 好 啊 如果 都 说 好看 就 无法 进步 了
这样 很 好 啊 如果 都 说 好看 就 无法 进步 了	好 的 一会儿 我 去 看
支持 你 哟	爱 你 等 你 回来 拍 你
爱 你 等 你 回来 拍 你	好 啊
早上好 亲爱 的	早 宝贝 吃 了 几顿 火锅 了
早 宝贝 吃 了 几顿 火锅 了	两顿 刚来 的 第一天 吃 了 一顿 就 来 大姨妈 了 后来 再三 请求 才 又 吃 了 一顿
对 的	你们 都 金 了 好 刺眼 啊
你们 都 金 了 好 刺眼 啊	加油 你 也 可以
聚焦 年 两会 好人 一生 平安 不要 像 我 丢 了 手机 报警 都 没用 报警 之后 蜀黍 正在 忙 着 抢红包	临近 春节 时 手机 也 被盗 了 我 都 不 指望 警察 蜀黍 了 没 去 报案 直接 进 手机店 买 新 的
临近 春节 时 手机 也 被盗 了 我 都 不 指望 警察 蜀黍 了 没 去 报案 直接 进 手机店 买 新 的	有钱 任性
我 这么 优秀 的 男人 怎么 没 老婆	你 优秀 在 哪
你 优秀 在 哪	哪里 都 好 就是 没 钱
我来 娶 你 吧	你 会 不会 像 用 针扎 紫薇 那样 扎 我 的
你 会 不会 像 用 针扎 紫薇 那样 扎 我 的	不会 的 我会 很 疼爱 你 的
不会 的 我会 很 疼爱 你 的	升金 了 用 针该 用 金 的 你 一 扎上来 我 就 跑 然后 去 换
我 已经 准备 好 了 打包带 进来 吧	能信 么
能信 么	必须 能 啊 一直 都 开 着 等 你 在
必须 能 啊 一直 都 开 着 等 你 在	愚人节
愚人节	哈哈
你 是 差个 去 火星 的 机票	坐 火箭 去
坐 火箭 去	不错 哦 我 还 没 坐 过 呢
不错 哦 我 还 没 坐 过 呢	一起 坐 呗
打包带 走	太重 带 不 走
太重 带 不 走	不 托运
为啥 不是 被 表白	我 也 在 想 这 问题 我 想 是 没人 喜欢 我
我 也 在 想 这 问题 我 想 是 没人 喜欢 我	我 喜欢 啊
妳 现在 可以 表白 了	快 教教 我
快 教教 我	妳 先 表白 啊
妳 先 表白 啊	你 先 教会 我 我 在 说
你 先 教会 我 我 在 说	你 也 真是 滴 这么 蠢 这样 说 就行了 你 要 爱 我 我 就 同意 嫁给 你 就是 了
你 也 真是 滴 这么 蠢 这样 说 就行了 你 要 爱 我 我 就 同意 嫁给 你 就是 了	哇 哦 等 下去 说
喜欢 你 人来 了	来 了 就 别 走
来 了 就 别 走	妳 又 不敢 收留 说 什么 不要 走
妳 又 不敢 收留 说 什么 不要 走	爱 我别 走
爱 我别 走	互个 朋友
小心 被整	昨晚 就 被 人整 了
昨晚 就 被 人整 了	整了 好 快乐 了
整了 好 快乐 了	不 快乐 被 他 坑 了 元
不 快乐 被 他 坑 了 元	比流 到 别处 强
新浪 给 我配 的 图 让 我 很 不 满意	你 的 是 什么 快 让 我 看看
你 的 是 什么 快 让 我 看看	下面 的 配图 是 个 女 的 前 凸后 翘 那种
下面 的 配图 是 个 女 的 前 凸后 翘 那种	微博对 你 真 好 送个 美女 给 你
微博对 你 真 好 送个 美女 给 你	挺 逗 的 节日快乐
你 用 错 表情 了	你 火 了 能 帮 我 烤 个 全羊 么
你 火 了 能 帮 我 烤 个 全羊 么	这位 客官 不好意思 烤全羊 没 被 抢光 了 还有 半羊 请问 你 需要 么
这位 客官 不好意思 烤全羊 没 被 抢光 了 还有 半羊 请问 你 需要 么	快点 送来
挺好玩	你 的 是 什么
你 的 是 什么	怎么 玩 呀
怎么 玩 呀	去 热 搜看
去 热 搜看	看 了 不 懂 怎么 玩
为什么 我 吃 了 一次 就 不想 再 吃 了	为什么 我 没 看见 过
为什么 我 没 看见 过	我 学校 原来 就 有 现在 不 知道 还有 没有 了
这 都 是 些 什么 鬼	左边 兰花 右边 铜钱 草
左边 兰花 右边 铜钱 草	看不出来
看不出来	应该 说 你 认不出来
不得 农药	很累
很累	杭州 第一 旋转 程咬金
小孩 头发 怎么回事 是 自己 脱落 的 还是 你们 剪 的 要是 自己 脱落 的 可能 是 斑秃 的 现象	出生 就 这样 不过 现在 在 长 头发
出生 就 这样 不过 现在 在 长 头发	嗯 那 就 没有 关系
嗯 那 就 没有 关系	你 是 医生 吗
你 是 医生 吗	是 的
是 的	噢 好 的 谢谢 你
才 七个 月 就 断奶	嗯 咯 我 的 奶 没有 营养 了
嗯 咯 我 的 奶 没有 营养 了	你 怎么 知道 没有 营养
你 怎么 知道 没有 营养	好久 了 都 没 怎么 长 而且 来 姨妈 的 时候 奶 就 缺少 营养 了 还 不是 干脆 戒奶 算了
好久 了 都 没 怎么 长 而且 来 姨妈 的 时候 奶 就 缺少 营养 了 还 不是 干脆 戒奶 算了	我 现在 都还没 来 姨妈 她 长得 胖胖 哒
我 现在 都还没 来 姨妈 她 长得 胖胖 哒	允个 月 的 时候 来 的 大姨妈 去 体检 比 上上个月 的 都 没长 什么 还是 愿戒 看算 的
这 零食 都 是 小孩子 吃 的 啊	我 就是 小孩子 啊
我 就是 小孩子 啊	小屁孩 呀
小屁孩 呀	你 的 微信 是 怎么 加 的 啊
你 的 微信 是 怎么 加 的 啊	为什么 要 啊
为什么 要 啊	我 看见 别人 和 你 的 对话 了 啊
我 看见 别人 和 你 的 对话 了 啊	啥意思
啥意思	就是 别人 也 给 你 要 微信 了 啊
侧脸 杀	几个 意思 哦
几个 意思 哦	就是 很漂亮 的 意思 侧脸 秒杀 所有 男 的
就是 很漂亮 的 意思 侧脸 秒杀 所有 男 的	我 理解 了 我 问 的 是 你 这样 夸张 的 夸 我 几个 意思
我 理解 了 我 问 的 是 你 这样 夸张 的 夸 我 几个 意思	小生 愚钝 原来 是 这样
小生 愚钝 原来 是 这样	大美女 啊
大美女 啊	没有 没有
同 河南	嗯 呢
嗯 呢	哈哈哈 能加 你 微信 吗
哈哈哈 能加 你 微信 吗	怎么 了
怎么 了	没事 交个 朋友
我 说 过 同样 的话	后来 呢
后来 呢	放 她 自由
我 选有 女朋友	纳尼
纳尼	汪懂 了 吧
汪懂 了 吧	秒 懂
坐等 再 翻 哈哈哈	哈哈哈哈 不会 的
哈哈哈哈 不会 的	万一 呢 哈哈哈
天 啊 这字 太 好看 了 做梦 都 想练成 这样 的 字 啊啊啊 啊 你 是 自己 练 的 还是 学过 书法 啊啊啊 啊 还有 这个 笔尖 好像	我 我 我 没学过 书法 啊 啊 是 毕加索 这个 不好 用 后面 那个 用朝 颜写 的 是 白 了 微笑 超 喜欢
我 我 我 没学过 书法 啊 啊 是 毕加索 这个 不好 用 后面 那个 用朝 颜写 的 是 白 了 微笑 超 喜欢	妈呀 自己 写 着 玩玩 能 写 得 这么 好看 厉害 了 啊啊啊
妈呀 自己 写 着 玩玩 能 写 得 这么 好看 厉害 了 啊啊啊	蟹 蟹 你 啦 猴 嗨 森噜噜 噜 噜 噜 噜 噜 你 的 字 也 很 好看 啊
蟹 蟹 你 啦 猴 嗨 森噜噜 噜 噜 噜 噜 噜 你 的 字 也 很 好看 啊	我 一直 都 想 写出 这种 行云流水 的 感觉 我 的 字 驾驭 不了 钢笔
我 一直 都 想 写出 这种 行云流水 的 感觉 我 的 字 驾驭 不了 钢笔	图片 里 那个 蓝 实在 是 太 好看 了 可是 买回来 发现 买家 秀 和 卖家 秀 真是
图片 里 那个 蓝 实在 是 太 好看 了 可是 买回来 发现 买家 秀 和 卖家 秀 真是	买回来 不 好看 了 吗
买回来 不 好看 了 吗	布朗 熊卖 没 了 哇
布朗 熊卖 没 了 哇	去 咸鱼 上 瞅 瞅 德国 带 回来 的
去 咸鱼 上 瞅 瞅 德国 带 回来 的	你 啥时候 过生日
你 啥时候 过生日	几个 月 以后 快 了
你 这么 不 愿意 回 学校 么	大娘 孩儿 我 根本 不想 上学
大娘 孩儿 我 根本 不想 上学	我 也 是
我 日 我 不 懂 了	不 懂 啥
不 懂 啥	我 不敢 说
我 不敢 说	傻比
我 只是 一个 黑白 粉	你 的 头像 有点 可爱 啊 我 要 抱 走 画 表情 包
你 的 头像 有点 可爱 啊 我 要 抱 走 画 表情 包	拿 去 吧
非非 非	你 羡慕
你 羡慕	你 怎么 知道
最 讨厌 你 这种 秀 美食 又 不 给 我 吃 的 人	你 只要 来 了 绝对 有 得 吃
你 只要 来 了 绝对 有 得 吃	你 等 着
你 等 着	等 着
看着 好 好吃 深夜 报复 社会 啊	广东 糖水 最 好吃 了 品种 还 好多
广东 糖水 最 好吃 了 品种 还 好多	甜品 太多 了 过 得 太 安逸
甜品 太多 了 过 得 太 安逸	广东 的 糖水 最 简单 不 奢侈 最 容易 做
我 可 正好 相反	我 看 一会儿 后 兴奋 感 就 消失 了
我 看 一会儿 后 兴奋 感 就 消失 了	真淡定 我 是 一 看 就 想 买 放 购物车 几天 就 沉淀 了
是 你	宿舍 布局 都 一样
宿舍 布局 都 一样	这 不 就是 咱们 学校 么 是不是 傻 这个 博主 就是 工大 的
这 不 就是 咱们 学校 么 是不是 傻 这个 博主 就是 工大 的	靠靠 靠 我 是 脑残 我 是 脑残
是 啊 文字 越来越少 思念 越来越 深	哎 对 呀
哎 对 呀	慢慢 放心 底
自杀 情节	不好 说
不好 说	崴 妖 妖灵 吗 这里 需要 帮助
崴 妖 妖灵 吗 这里 需要 帮助	别 裹乱
别 裹乱	请 用鳝
请 用鳝	大舅 你 学坏 了
大舅 你 学坏 了	大舅 是 鳝 变 的
大舅 是 鳝 变 的	原来 视频 里 女主播 的 鳝 是 你
原来 视频 里 女主播 的 鳝 是 你	不 不 不 那个 不是 我
不 不 不 那个 不是 我	你别 解释 了
你 咋 滴 想 放飞 自己 了	我 放飞 不 起来 啊
我 放飞 不 起来 啊	可 拉倒 吧 老老实实 在 地上 待 着 吧
可 拉倒 吧 老老实实 在 地上 待 着 吧	我 带 你 飞
我 带 你 飞	我 喜欢 拥抱 大地
我 喜欢 拥抱 大地	来 下次 见面 你 拥抱 我 看看
来 下次 见面 你 拥抱 我 看看	大地 你好
大地 你好	嗯 大地 之母
为什么 扭成 这样	有人 说 他 是 腹肌 少女
有人 说 他 是 腹肌 少女	到底 发生 了 什么
的确 有点 少女	刚看 了 下 这次 只有 第一季 而已 集 不 知道 剧情 能 播到 哪 希望 不是 泡面 番 一集 时间 长点
刚看 了 下 这次 只有 第一季 而已 集 不 知道 剧情 能 播到 哪 希望 不是 泡面 番 一集 时间 长点	纯粹 针对 这 张图 的 姿势 感觉 很 不太爽
纯粹 针对 这 张图 的 姿势 感觉 很 不太爽	因为 内八 吗
因为 内八 吗	整个 姿势 模板 像 女孩子 啊
整个 姿势 模板 像 女孩子 啊	那个 露 的 有点 骚
还有 四天	是 啊 不过 这次 就 第一季 出 的 好 少 啊
是 啊 不过 这次 就 第一季 出 的 好 少 啊	别 第一季 就 说 叶修 退役 然后 刚刚 到 欣欣 打工
好久 都 没有 看到 我们 彬儿 了	那 你 想 不想 我 呀
那 你 想 不想 我 呀	想 啊 想 啊
想 啊 想 啊	那 暑假 回来 耍
那 暑假 回来 耍	清明节 都 没 回来 啊
清明节 都 没 回来 啊	没有
没有	好想你 了 啊 暑假 早点 回来 呀
好想你 了 啊 暑假 早点 回来 呀	嗯
一瓶 卤 油膏	一瓶 你 油膏 要 知道 想 把 卤蛋 榨出 油是 一件 非常 困难 的 事 数百个 卤蛋 才能 榨出 几滴 油膏 因此 卤 油膏 是 非常 珍贵 及 昂贵 的 护肤品 市面上 难得一见
一瓶 你 油膏 要 知道 想 把 卤蛋 榨出 油是 一件 非常 困难 的 事 数百个 卤蛋 才能 榨出 几滴 油膏 因此 卤 油膏 是 非常 珍贵 及 昂贵 的 护肤品 市面上 难得一见	恐惧 卤蛋 竟然 想 谋害 它 的 父亲
恐惧 卤蛋 竟然 想 谋害 它 的 父亲	只是 阐述 卤 油膏 的 制作 工艺 现在 卤王 知道 为何 你 的 子民 数量 锐减 了 吧 用 卤王 制作 的 卤 油膏 可以 说 是 天地 至宝 了 非常 期待 使用
只是 阐述 卤 油膏 的 制作 工艺 现在 卤王 知道 为何 你 的 子民 数量 锐减 了 吧 用 卤王 制作 的 卤 油膏 可以 说 是 天地 至宝 了 非常 期待 使用	等待 成为 卤王 油膏 吧 会心一笑
等待 成为 卤王 油膏 吧 会心一笑	卤 你 可能 见 不到 明天 的 太阳 了 我 正在 提刀 赶来
卤 你 可能 见 不到 明天 的 太阳 了 我 正在 提刀 赶来	来 吧 卤 天气预报 说 明天 下雨 一下子 接受 不了 吧
来 吧 卤 天气预报 说 明天 下雨 一下子 接受 不了 吧	哪里 有 卤王 的 压迫 哪里 就 有 反抗 揭刀 起义 殴打 卤王
哪里 有 卤王 的 压迫 哪里 就 有 反抗 揭刀 起义 殴打 卤王	对 你 压迫 我们 穷苦 人民 我们 要 反抗
辰长 之 路演 夜华 如何	妥 妥儿 的 比 咩 成熟 一些
妥 妥儿 的 比 咩 成熟 一些	看 了 下 他 的 微博 难怪 有人 说 他 用 九世 智商 换 一世 颜
看 了 下 他 的 微博 难怪 有人 说 他 用 九世 智商 换 一世 颜	哈哈哈 真的 吗 我 没 关注 他 我 去 围观 下
妈呀 男 的 唱 也 能 这么 媚 吗	弹幕 里 好多 人想 睡 了 他 简直 就是 大 师兄 唱 的
弹幕 里 好多 人想 睡 了 他 简直 就是 大 师兄 唱 的	哈哈哈
节哀	谢谢 弟弟
谢谢 弟弟	早点 休息
今天 在 学校 看到 一个 很妹 纸 侧面 和 你 好像 走路 姿势 也 像 也 背着 小 红包	是 我 你 怎么 不喊 我 呀
是 我 你 怎么 不喊 我 呀	我 喊 了 声 大美女 这 一点 和 你 很 不 一致 啊
我 喊 了 声 大美女 这 一点 和 你 很 不 一致 啊	我 听见 了 真 丢人 特意 没回 的 头
我 听见 了 真 丢人 特意 没回 的 头	什么 时候 变 的 这么 不 自信 了
什么 时候 变 的 这么 不 自信 了	这是 正确 的 自我 认知
这是 正确 的 自我 认知	瞎说 明明 就是 大美妞
瞎说 明明 就是 大美妞	我会 还 钱 的
我会 还 钱 的	快 还 完 了
什么 嘛 你 要 做 吗	对 呀 我 有 个 原浆 机
对 呀 我 有 个 原浆 机	赶紧 做 起来 我 现在 每天 早上 打 蔬果 昔喝生 的 蔬菜 加 水果 排毒
我能 吐 槽 下图 好丑 吗	可以 的 咪 咕 原生 读者群 年龄 偏下 原来 高大 上 的 封面 被 认为 恐怖 小说 都 吓跑 了 所以 才 搞了个 粉红 粉红 的
可以 的 咪 咕 原生 读者群 年龄 偏下 原来 高大 上 的 封面 被 认为 恐怖 小说 都 吓跑 了 所以 才 搞了个 粉红 粉红 的	这 突然 膝盖 中 了 一箭 是 怎么回事 我 也 才 呀
我 只能 说 把 之一 去 了 就是 我 了	亲爱 的 还有 那么 多 历史剧 大明 汉 武大 秦 我 的 三国
亲爱 的 还有 那么 多 历史剧 大明 汉 武大 秦 我 的 三国	然而 最 爱 只有 一个
这段 看 的 气死人 真心 心疼 雍正	更 应该 心疼 的 是 老 十三
更 应该 心疼 的 是 老 十三	活活 累死
我 也 差 不 都 但 我 没有 之一	别 啊 还是 汉武大帝 大秦 帝国 只能 是 之一
别 啊 还是 汉武大帝 大秦 帝国 只能 是 之一	哈哈 我排 第一 的 是 雍 王汉大排 第二 大帝 没 看过
值得 看 拍 的 蛮 好 的 结合 弹幕 看 更 美味 哦	身边 好多 机油 本着 王重阳 去 了 我 的 朋友圈 都 被 王重阳 的 图片 沦陷 了
身边 好多 机油 本着 王重阳 去 了 我 的 朋友圈 都 被 王重阳 的 图片 沦陷 了	我 不会 说 就 为了 这 不到 一分钟 的 镜头 我冲 了 会员
我 不会 说 就 为了 这 不到 一分钟 的 镜头 我冲 了 会员	你 是 真爱点 赞栋哥 以后 就 走 这 路线 肯定 吸粉 无数
你 是 真爱点 赞栋哥 以后 就 走 这 路线 肯定 吸粉 无数	我 和 朋友 聊天 也 是 说 如果 他 一直 这个 路线 简直 不能 更赞 当然 其他 风格 也好
我 和 朋友 聊天 也 是 说 如果 他 一直 这个 路线 简直 不能 更赞 当然 其他 风格 也好	是 的 风格 可以 多多 尝试 但 这款 路线 值得 保留 颜值 和 演技 在线 赞
是 的 风格 可以 多多 尝试 但 这款 路线 值得 保留 颜值 和 演技 在线 赞	特别 奇怪 我 看 这里 的 时候 是 被 他 眼神 的 演技 吸引 的 眼神 一 动一动 的
特别 奇怪 我 看 这里 的 时候 是 被 他 眼神 的 演技 吸引 的 眼神 一 动一动 的	不 需要 台词 眼神 已经 把戏 演活 了 发觉 就 这 路线 好多 戏栋哥 都 能 驾驭
不 需要 台词 眼神 已经 把戏 演活 了 发觉 就 这 路线 好多 戏栋哥 都 能 驾驭	对 对 对 我 朋友 看 了 王重阳 然后 和 我 吐 槽 他 之前 演 的 韦小宝 那 类型 的
对 对 对 我 朋友 看 了 王重阳 然后 和 我 吐 槽 他 之前 演 的 韦小宝 那 类型 的	今天 我 成功 的 把 栋 哥 的 王重阳 推荐 给 身边 的 机油 了 都 说 颜值 最高 的 中 神通
今天 我 成功 的 把 栋 哥 的 王重阳 推荐 给 身边 的 机油 了 都 说 颜值 最高 的 中 神通	真好 你 还 能 安利 我 周围 都 没人
真好 你 还 能 安利 我 周围 都 没人	你 的 小伙伴 呢
你 的 小伙伴 呢	都 不粉 这种 的 有 个 喜欢 韩国 的
都 不粉 这种 的 有 个 喜欢 韩国 的	对 棒子 无感 我 喜欢 古风 多美 啊
对 棒子 无感 我 喜欢 古风 多美 啊	我 的 闺蜜 都 不哈 这种 的 所以 我 很 痛苦 没有 办法 分享
我 的 闺蜜 都 不哈 这种 的 所以 我 很 痛苦 没有 办法 分享	啊哈 我 身边 机油 都 是 靠 谱 青年 逮到 颜值 高 的 大家 一起 分享 张智尧 李玉刚
哈哈哈 我 朋友 看 了 这 视频 以后 就 来说 你家 栋哥 以后 还是 多 走 这种 沉稳 路线 才行	以后 逗比 的 角色 还是 偶尔 尝试 尝试 吧 别 一去不复返
以后 逗比 的 角色 还是 偶尔 尝试 尝试 吧 别 一去不复返	不过 逗比 的 角色 好像 其实 不 多
不过 逗比 的 角色 好像 其实 不 多	经典 角色 一个 能 让 大家 记忆犹新 哒
求 问川大 望江 和 江安 校区 宿舍 都 是 木制 上床 下桌 咩	不 一定 尤其 是 望江 可能 是 上下床
不 一定 尤其 是 望江 可能 是 上下床	谢谢
来 吧	某人 身高体重 写 完 了 恐怖 不
某人 身高体重 写 完 了 恐怖 不	昨晚 的 梦 更 恐怖
咋 了 啊	不太 开心
不太 开心	咋啦 吃点 好吃 的 呗
没 问题 吧	让 我 去 做 我 还 没敢 去 呢 应该 没 啥事
让 我 去 做 我 还 没敢 去 呢 应该 没 啥事	都 检查 下 吧 就 不用 那么 揪心 了
返图 也 是 美美 的 心境 好久不见 的 彩虹	嘿嘿 渣 图渣 图妹 纸 的 手艺 很 好 哦 小 铃铛 想着 心情 也 会 很 好
嘿嘿 渣 图渣 图妹 纸 的 手艺 很 好 哦 小 铃铛 想着 心情 也 会 很 好	可 喜欢 哪个 铃铛 了 客气 啥 会 继续 努力 的
可 喜欢 哪个 铃铛 了 客气 啥 会 继续 努力 的	继续 支持 你
继续 支持 你	谢谢
在 这个 微博 留言 不 成功 我 也 不 知道 为什么 很心水 那串 芙 蕖 呐	嗯 估計 新浪 抽風 那個 暫時 沒 有 了 吶
嗯 估計 新浪 抽風 那個 暫時 沒 有 了 吶	哦
哦	還會 有 更好 的
還會 有 更好 的	期待
这 是 你 的 店面 对 吧 好 美 已 关注	是 的 一个 现货 铺子 一个 只有 订单 的
是 的 一个 现货 铺子 一个 只有 订单 的	淘宝 再 关注
白 老板 看 我 呀 淘宝 和 两边 微博 都 留言 私信 了 想订 珠子 呀 白 老板 快 粗线	口 不好意思 我 还 在 外头 没 上 旺旺 等 我 下午 回家吧 嗯 好 咩 不好意思
口 不好意思 我 还 在 外头 没 上 旺旺 等 我 下午 回家吧 嗯 好 咩 不好意思	没关系 只要 看到 我 就 好
没关系 只要 看到 我 就 好	到家 我 先 收拾 下过 会 打开 电脑 去
到家 我 先 收拾 下过 会 打开 电脑 去	嗯
鱼子 为何 我 无法 评论 东青 的 博	估计 没有 关注
估计 没有 关注	窝 关注 惹 了 啊 一定 要 泥 关注 我 吗
窝 关注 惹 了 啊 一定 要 泥 关注 我 吗	估计 是 新浪 抽风
高中 开始 从 商家 吧 摸 到 鱼 的 淘宝 店 一直 想 给 自己 定个 簪子 可是 高中 一直 剪短 发 毕业 之后 好不容易 留长 了 又 被 麻麻 拉 去 剪短 今天 无意之中 看到 鱼 的 微博 好开心 啊 马上 要 出远门 很 久 回来 的 时候 一定 要来定 东西 话 说 我 一直 以为 鱼 是 位 妹子 到底 是不是 呀	嗯 哈 谢谢 惦记 这里 好 的 呀 嗯 我 一直 在 所以 随时 都 可以 对 的 是 姑娘
嗯 哈 谢谢 惦记 这里 好 的 呀 嗯 我 一直 在 所以 随时 都 可以 对 的 是 姑娘	恩恩 就 知道 是 个 细腻 的 妹子
土豪 开新 店铺	为了 作 死
为了 作 死	祝福 你 !
祝福 你 !	踹 既然 爱 我 就 帮 我 啦
踹 既然 爱 我 就 帮 我 啦	我 不会 做 . 只有 靠 你 呀 !
我 不会 做 . 只有 靠 你 呀 !	要是 你 真的 弯 我 跟 你 的话 估计 饿死
要是 你 真的 弯 我 跟 你 的话 估计 饿死	噗 !
嗷 虽然 分开 了 不过 以后 就 可以 两边 一起 敲打 了	口有 的 放心 其实 都 是 我 一个 人 打理
口有 的 放心 其实 都 是 我 一个 人 打理	辛苦 了 顺毛
辛苦 了 顺毛	所以 请 温柔 鞭策 我
两边 都 是 我 的 爱	阿 哈哈 我来 占 鱼子 便宜 抱住 蹭 蹭
阿 哈哈 我来 占 鱼子 便宜 抱住 蹭 蹭	好 的 好 的 把 肉 肉 都 给 你 哈哈
好 的 好 的 把 肉 肉 都 给 你 哈哈	抓住 住 你 肥 嫩嫩的 小 爪子 咬
抓住 住 你 肥 嫩嫩的 小 爪子 咬	游走
不 打 副本 的 就 看看 什么 叫秀 操作 怎么 秀	打 男神 的 时候 男神会 瞬移 到 旁边 的 小 台子上 会 玩 的 人会 追 着 他 打 尤其 是 一些 明教 藏剑 因为 台子 小 就 会 掉下去 掉下去 很 容易 就 摔死 现在 打 根本 不 需要 跳过去 追着 令狐 伤 打 就 好好 的 等 他 回来 就行 就 有 一群 人 特别 喜欢 在 这个 时候 我能 跳过去 你们 信不信 我 试试 我能 不能 跳过去
打 男神 的 时候 男神会 瞬移 到 旁边 的 小 台子上 会 玩 的 人会 追 着 他 打 尤其 是 一些 明教 藏剑 因为 台子 小 就 会 掉下去 掉下去 很 容易 就 摔死 现在 打 根本 不 需要 跳过去 追着 令狐 伤 打 就 好好 的 等 他 回来 就行 就 有 一群 人 特别 喜欢 在 这个 时候 我能 跳过去 你们 信不信 我 试试 我能 不能 跳过去	也 可能 不 知道 就 追过去 了 吧
也 可能 不 知道 就 追过去 了 吧	不会 团长 喊 了 停手 的
不会 团长 喊 了 停手 的	哦 后来 那有 摔死 的 没有
哦 后来 那有 摔死 的 没有	死 了 啊 黑 了 我 的 无伤 还有 安禄山 那 打 完 安禄山 会 被 定 住 但是 上天 就 可以 不 被 定 今天 就 有 个 剑 纯 上天 了 没 操作 好 在 安禄山 死前 一秒 摔死 了 我 亲友 都 疯 了 他 刚刚 还 跟 我 说 这次 无伤 稳 了
死 了 啊 黑 了 我 的 无伤 还有 安禄山 那 打 完 安禄山 会 被 定 住 但是 上天 就 可以 不 被 定 今天 就 有 个 剑 纯 上天 了 没 操作 好 在 安禄山 死前 一秒 摔死 了 我 亲友 都 疯 了 他 刚刚 还 跟 我 说 这次 无伤 稳 了	哦 哦
哦 哦	悄悄的 给 你 看 一眼 一个 绝望 的 气纯
悄悄的 给 你 看 一眼 一个 绝望 的 气纯	好 怎么 给 我 看
你 说 的 不会 是 你 吧	哈 你 这 名字 是 天天 放屁 的 意思
哈 你 这 名字 是 天天 放屁 的 意思	你 上次 就 问过 啦 意思 是 整天 这么 忙 屁事 也 没 干成
什么 梗	不是 梗 , 真 事儿
不是 梗 , 真 事儿	是 你 吗
是 你 吗	不是 啊 我 是 单身 狗
这么 多悲 催 的 事例 想想 都 怕	不过 感情 是 真的 好
不过 感情 是 真的 好	感情 好 胜过 一切 胖 并 幸福 着
感情 好 胜过 一切 胖 并 幸福 着	冷暖自知
冷暖自知	貌似 不合 外人 眼 其实 幸福 着
喵 别以为 我 不 知道 你 的 想法 不 跟 你 玩	小 哥哥 人艰 不 拆 啊
小 哥哥 人艰 不 拆 啊	小姐姐 人生 艰难 能 拆 就 拆 啊
小姐姐 人生 艰难 能 拆 就 拆 啊	小姐姐 向 你 丢 过来 一万个 白眼 仁
真 潇洒	这 就是 青春 啊
这 就是 青春 啊	你 多 大 了 私信 告诉 我
你 多 大 了 私信 告诉 我	不 告诉 你
不 告诉 你	后
你 是 里面 哪 一个	我 不 在 里面
我 不 在 里面	你 只 拍 别人 吗 我 看 了 你 相册 似乎 都 没有 你
你 只 拍 别人 吗 我 看 了 你 相册 似乎 都 没有 你	没有 啊
吃饭 啦	早 吃 了 你 呢
早 吃 了 你 呢	刚 吃 完
刚 吃 完	饭饱神 虚 睡一觉
饭饱神 虚 睡一觉	好 吧
带我去 次	老头儿 油爆 虾 你 这个 吃货 居然 没吃过 吗
老头儿 油爆 虾 你 这个 吃货 居然 没吃过 吗	你 又 不 带 我 混 杭州
你 又 不 带 我 混 杭州	你 混 杭州 还 用人 带 不要 混 的 太熟 哦
拍菜 的 时候 镜头 拉远点 曝光 注意 下 菜 不错 应该 拍 的 不行	华为
华为	这个 软件
这个 软件	已经 下载 了 改天 出去 腐败 一下 试试 多谢 你 啦
已经 下载 了 改天 出去 腐败 一下 试试 多谢 你 啦	客气 啦 好 东西 就是 需要 分享 的
霍 建华 哥哥 美图 我 的 最 爱 霍 建华 如懿传	看着 就 开心
看着 就 开心	超级 喜欢
蛋饺 好吃 吗	应该 会 很 好吃
应该 会 很 好吃	想 吃
这是 什么 啊	跑步 的 米数
跑步 的 米数	喔 那 你 比较 厉害 了
龟苓膏 双皮奶	凉粉 和 姜撞奶
凉粉 和 姜撞奶	全都 猜错 了 好 尴尬 呀
电影版 说 抄袭 的 寥寥无几 电视 版 说 抄袭 的 那么 多 都 是 打着 反 抄袭 的 旗号 互 踩 到 最后 没 几个 人去 关注 抄袭 这 套路 深 呀	差评 完 了 就 走 这 阵势 说 不 知道 抄袭 绝对 是 装傻
差评 完 了 就 走 这 阵势 说 不 知道 抄袭 绝对 是 装傻	看着 真的 很心 塞 连 都 帮 着 推广 前段时间 还 指出 抄袭 朝令夕改 连 个 立场 都 不 站
举手 报名 修图 风格 可以 到 我 的 看到 首页 有 地址	哟 哟 你 很 迅速 啊
哟 哟 你 很 迅速 啊	必须 的
卧槽 我 喜欢	喜欢 我 你 这么 直白
喜欢 我 你 这么 直白	我 喜欢 高中 的 樱花
第一张 图 好像 九龙 哦	你 眼力 这么 好安
你 眼力 这么 好安	狗子 的 想 欺骗 圈友
希望 生活 总 有心人 少 一点 好 尴尬 哦	祝 你 四级 记得 涂卡
祝 你 四级 记得 涂卡	你 数个 蛋糕 有 几个 没 得
会 让 知识 充满 你 的 全部	好丑 哦 最近
好丑 哦 最近	在 我 眼里 你 随时 都 很 美
同问 怎么 找到 的	上能 听
上能 听	谢谢
上图 上 图	只有 开吃前 的 一张 当时 还是 满心 期待 的
只有 开吃前 的 一张 当时 还是 满心 期待 的	哈哈 看着 很 不错呀
我 也 想 看求 资源	完整版
完整版	求 第一集
我 觉得 我 肯定 会 很 难受 因为 我 特别 喜欢 这样 个性 的 男人 可能 更 甚于 华信	怎么 能 看到 全集 求助
怎么 能 看到 全集 求助	你 公众 号 找 小玩剧
最佳 李顺心 用 哪个 可以 看	不 知道 还 没 看 这个
不 知道 还 没 看 这个	我 每天 都 看一遍 嫉妒 的 最后 一集 无法自拔
哥哥 是 在 拍 好 这部 戏 以后 接 的 观相 么 演技 的 化身	好像 和 建筑学 概论 是 同一 时期 拍 的 拍 完 建筑学 就 拍 的 殷 大尉
好像 和 建筑学 概论 是 同一 时期 拍 的 拍 完 建筑学 就 拍 的 殷 大尉	嗯 嗯
博主	哈哈哈哈 就 知道 快 进拉 的 痛苦 果断 帮 大家 剪 了
哈哈哈哈 就 知道 快 进拉 的 痛苦 果断 帮 大家 剪 了	大爱博主
殷 大尉 的 爱情 戏 有没有 打动 你 我 一直 不敢 看 还 没有 心理准备	必须 有 很 美 很 虐 主要 是 演得 太好 完全 不同 的 曹 演员
必须 有 很 美 很 虐 主要 是 演得 太好 完全 不同 的 曹 演员	都 是 好评 为什么 曹 演员 当年 没有 红 起来 现在 真的 有 大器晚成 的 感觉
太好了	实在 舍不得 弃 殷始庆 昨天 还是 决定 把 最后 十集 捡起来 造福 大家 哈哈哈哈
实在 舍不得 弃 殷始庆 昨天 还是 决定 把 最后 十集 捡起来 造福 大家 哈哈哈哈	干 的 漂亮 哦 哦 我 和 你 说 我 昨天晚上 看 了 逆 鳞 又 是 一个 让 人 落泪 的 角色 很 心酸
干 的 漂亮 哦 哦 我 和 你 说 我 昨天晚上 看 了 逆 鳞 又 是 一个 让 人 落泪 的 角色 很 心酸	真的 吗 补补 补 但是 为什么 看 那个 造型 那么 想 笑 哈哈哈
我 看 了 吻 戏 哈哈哈 哈哈	你 除了 信娜丽 哪部 剧 不是 只 看 吻 戏
你 除了 信娜丽 哪部 剧 不是 只 看 吻 戏	我哥 电视剧 吻 戏 阅览 完毕 负责 的 说 把 迄今为止 最好 的 吻 技都 给 了 娜丽
大师 啥 机	手机
手机	哇塞 真的假 的 超美 我 真的 以为 相机 拍 的
哇塞 真的假 的 超美 我 真的 以为 相机 拍 的	利用 灯光 后期 再 调调 色 你 也 可以 的
哈哈哈 哈哈 这张 真的 是 叔叔	苹果 肌 和 脸上 的 肉 已经 无缝 衔接 了
苹果 肌 和 脸上 的 肉 已经 无缝 衔接 了	哈哈哈哈 并且 下巴 和 脖子 也 无缝 衔接
新 电影 女主定 了 吗	裴斗娜
裴斗娜	啥时候 能 有 新剧 呢
啥时候 能 有 新剧 呢	希望 在 下半年 哈哈哈 哈哈
不 小心 混入 理科班	大学 恋爱 毕业 两年 结 的 婚 想想 岁 就 结了婚 啊 好 幼稚
大学 恋爱 毕业 两年 结 的 婚 想想 岁 就 结了婚 啊 好 幼稚	现在 看人 看事 的 角度 和 以前 不 一样 了 我 也 有 此 感觉
和 我 感受 几乎 一样 哈哈哈哈	你 也 看剧 了 么
你 也 看剧 了 么	我 以后 看 的 前面 刮 了 点 看 的 太 憋屈 哈哈 不过 后面 也 不是 每集 追 的
我 以后 看 的 前面 刮 了 点 看 的 太 憋屈 哈哈 不过 后面 也 不是 每集 追 的	差不多 多集 开始 看 不算 天天 追 之前 的 补 了 再 存个 多集 继续 看 其实 到 现在 才 看到 多集 总体 还是 不错 的 演员 选 的 好
怎么 了	不 开 会员 就 没法 图片 评论 了
不 开 会员 就 没法 图片 评论 了	开开 开 一起
开开 开 一起	嗯 不开 不行 了
哇塞 收到 啦	嗯 嗯 快 到 吓 着 我
嗯 嗯 快 到 吓 着 我	不用 等到 六月 了
不用 等到 六月 了	哈哈哈 是 啊
哇 你 真棒 我 也 在 学 韩语 还 在 学 发音	为了 大包 也 要 加快速度
为了 大包 也 要 加快速度	我 就是 为了 大包 才 下决心 学 的
我 就是 为了 大包 才 下决心 学 的	哈哈 !
啊 哈哈哈哈 哈哈哈哈 哈哈哈 哈哈哈	怎么样 不错 吧
怎么样 不错 吧	深刻 真食 形象 逼真 妙妙妙
深刻 真食 形象 逼真 妙妙妙	我 鸡腿 慧眼 如炬
噗 哈哈哈 哟 容易 啊 这 画功 没话说 完美	我 艾姐 好看 吧
我 艾姐 好看 吧	好看 的 说不出 话
我 也 去 不了 我 准备 抢个 票	感觉 也 不会 很 好 抢 吧 不过 你 抢 到 的话 怎么办
感觉 也 不会 很 好 抢 吧 不过 你 抢 到 的话 怎么办	嗯 不过 我 觉得 我家 的 网速 可能 抢 不到
嗯 不过 我 觉得 我家 的 网速 可能 抢 不到	就 当 练练手
就 当 练练手	不过 咱们 国内 能 抢 到 吗 同 说 需要 韩国 手机号 什么 的
不过 咱们 国内 能 抢 到 吗 同 说 需要 韩国 手机号 什么 的	我 以前 在 抢 演唱会 的 票 中国 手机号 也 可以 诶
我 以前 在 抢 演唱会 的 票 中国 手机号 也 可以 诶	那 就 行 剩下 的 看命 了
啊啊啊 啊 真的 啊 我 还 以为 是 微博 主人 设置 的 呢	知道 真相 的 你 眼泪 掉下来 了 吧
知道 真相 的 你 眼泪 掉下来 了 吧	微博 这招 我服
只是 剪 刘海 吗	剪 刘海 自己 来 就行了 不像 你 那么 精致
剪 刘海 自己 来 就行了 不像 你 那么 精致	那 你 搞 新发型 啊
那 你 搞 新发型 啊	我 陪 同学 的
唱歌 很 有 感染力 比张 好 太 多 为什么 不火	那年 拿下 快乐 男声 的 冠军 后 因为 乐队 的 事情 和 天娱 闹翻 了 从此 没有 上 过 湖南卫视 的 平台 张杰 可是 芒果 台 的 女婿 啊 待遇 天壤之别
那年 拿下 快乐 男声 的 冠军 后 因为 乐队 的 事情 和 天娱 闹翻 了 从此 没有 上 过 湖南卫视 的 平台 张杰 可是 芒果 台 的 女婿 啊 待遇 天壤之别	没有 其他 公司 签他 吗 真心 觉得 可惜 他 唱歌 很 好 声音 很 打动 人 和 杨宗纬 是 一个 类型 的 歌手
没有 其他 公司 签他 吗 真心 觉得 可惜 他 唱歌 很 好 声音 很 打动 人 和 杨宗纬 是 一个 类型 的 歌手	签了 华谊 只不过 他 是 创作 型 歌手 加上 平台 局限 所以 知名度 不是 很 高 确实 他 和 杨宗纬 的 风格 有些 象 而且 两人 关系 超铁
签了 华谊 只不过 他 是 创作 型 歌手 加上 平台 局限 所以 知名度 不是 很 高 确实 他 和 杨宗纬 的 风格 有些 象 而且 两人 关系 超铁	对于 音乐 他 应该 有 自己 的 坚持 才 会 和 马桶 台 闹僵 看看 马桶 台 都 捧 些 什么 人 啊 张杰 李宇春
对于 音乐 他 应该 有 自己 的 坚持 才 会 和 马桶 台 闹僵 看看 马桶 台 都 捧 些 什么 人 啊 张杰 李宇春	张杰 唱功 没 问题 就是 不能 打动 人
不平 就让 它平	中间 算错 了 连 着 下面 的 都 错 了
中间 算错 了 连 着 下面 的 都 错 了	我 都 错 这放 着 呢 管 它
我 都 错 这放 着 呢 管 它	赶紧 完事 让 我们 清净 清净 吧
赶紧 完事 让 我们 清净 清净 吧	早就 不想 干 了
这是 哪个 组合 呀	我 弄 的 太 模糊 啦
我 弄 的 太 模糊 啦	看来 我 想 得 没错 前面 那个 有点像 王嘉尔 所以 我 就 在 想 是不是
这 你 都 能 看 出来	哈哈哈哈 我 去 的 我加 的 原来 头发 那儿 有个 白边
哈哈哈哈 我 去 的 我加 的 原来 头发 那儿 有个 白边	厉害
给 你 翻译 一下 昨天 姜走 了 超人 昨天 预告 说 宋 民国 要 来	哈哈哈哈 抵消 了 你 的 痛
哈哈哈哈 抵消 了 你 的 痛	哈哈哈 还好 我 没有 很忧桑 也 没有 很 开心
好像 娄艺潇 是 女 一 赵丽颖 是 女 二	而且 这戏 要 讲 对 戏份 单人 戏份 不会 多到 哪儿 去 不 看好 还是 希望 能 接大 男 主戏 一对 足矣
而且 这戏 要 讲 对 戏份 单人 戏份 不会 多到 哪儿 去 不 看好 还是 希望 能 接大 男 主戏 一对 足矣	不 担心 还 不 知道 信息 是 真是假
这 电视剧 算是 我 小时候 看 的 了 都 快 忘 了 剧情 了 如果 真的 由栋 哥演 希望 他 演齐 三 公子 哈哈哈	好像 消息 是 真的 百度 上 都 有 这 说法 栋哥 演齐 三 公子
好像 消息 是 真的 百度 上 都 有 这 说法 栋哥 演齐 三 公子	太好了 不过 这剧 应该 有 的 等 了
太好了 不过 这剧 应该 有 的 等 了	希望 消息 是 真的 真的 就 不会 白等 了
我们 的 队伍 越来越 强大 厂	你 说 是 我们 的 队 俉 那 为何 都 是 我 在 唱独角戏 了 唱 到 我 没劲 了 想 歇息 了
你 说 是 我们 的 队 俉 那 为何 都 是 我 在 唱独角戏 了 唱 到 我 没劲 了 想 歇息 了	你 是 最 强大 的
你 是 最 强大 的	我 没 你 说 的 那么 强大 我 只是 普通人 也 会 累 的
张弓长 张 你 的 铁杆 粉丝 啊	是 的 我 是 弓哥 的 鐵杆 粉絲
是 的 我 是 弓哥 的 鐵杆 粉絲	祝 你 早日 如愿
祝 你 早日 如愿	謝謝 我 本來 就是 呀
謝謝 我 本來 就是 呀	本来 就是 什么
本来 就是 什么	弓哥 的 粉絲 呀
弓哥 的 粉絲 呀	岂止 是 粉丝 啊 他 都 说 你 是 他 的 梦 中 情人 了
岂止 是 粉丝 啊 他 都 说 你 是 他 的 梦 中 情人 了	不是 說 妳是 他 的 夢 中 情人 嗎
不是 說 妳是 他 的 夢 中 情人 嗎	我 不是 你 才 是
我 就是 这么 菜	你 这么 菜 我 都 喜欢 你 才 是 真 爱 呢
你 这么 菜 我 都 喜欢 你 才 是 真 爱 呢	爱 我 你 就 亲亲 我
心疼 我 想 了 想 还是 准备 去 现场	当年 说 过 的 现场 见 现在 啪啪 打脸
当年 说 过 的 现场 见 现在 啪啪 打脸	我 的 小伙伴 都 有事 不能 去 我 只能 一个 人 坚强 的 去 了
我 的 小伙伴 都 有事 不能 去 我 只能 一个 人 坚强 的 去 了	摸摸 下次 有缘 再见
证券 从业 吗 我 也 是 巧 不巧	贼 巧 了 哭 唧唧
贼 巧 了 哭 唧唧	我 是 八号 有点 绝望
然而 我 是 很 纠结 买 哪 一场	我 根本 没有 选择 嘤 嘤 嘤
我 根本 没有 选择 嘤 嘤 嘤	那 后面 几天 呢
那 后面 几天 呢	都 有 课 的
真的	一看 就是 个 胖子
一看 就是 个 胖子	没错 我 是 最 胖 的
没错 我 是 最 胖 的	我 西皮 第一个 不服
我 西皮 第一个 不服	哈哈哈哈 哈哈哈
老杜 我 因为 手机 升级 好像 退出 老大 的 群 可以 拉 我 一把 吧	你 在 里面 啊
你 在 里面 啊	不好意思 今天 手机 拿 去 升级 结果 掉 了 很多 东西 因为 新浪 没有 更新 结果 没有 看到 群 刚刚 跑 去 更新 了 一看 一切 又 回来 了 好 了 没事 了 到 家 我 便 心安 了
听出 了 一股 孤独 的 味道 很 容易 在 夜深人静 的 时候 想到 一些 过往 但 却 让 我 重新认识 了 赵露 这个 温文尔雅 声音 听 起来 让 人能 静下来 的 赵露	关注 她 的 作品 喜欢 上 她 你 会 发现 她 还有 很多 闪光点 的
关注 她 的 作品 喜欢 上 她 你 会 发现 她 还有 很多 闪光点 的	我 要告 我 妈 说 你 不让 我 好好 爱美 麟 让 我 脚 踩 两只 船
我 要告 我 妈 说 你 不让 我 好好 爱美 麟 让 我 脚 踩 两只 船	不 不 不 其实 博爱 也 挺 好 的
不 不 不 其实 博爱 也 挺 好 的	看吧 我 就 说 有种 不详 的 预感 吧
看吧 我 就 说 有种 不详 的 预感 吧	这 是 好 的 预感 好 吧
这 是 好 的 预感 好 吧	不爱 你 了 分手 吧
不爱 你 了 分手 吧	不 拒绝 你 说 爱 我 一辈子 的 虽然 说 好像 有点 长 了 哈哈哈 哈哈哈
薛之谦 世界 巡回演唱 会 别生气 为 那些 人 不 值得 在意 的话 是 我们 输 了	不好意思 手机 换过 了 那些 图 都 没有 了
不好意思 手机 换过 了 那些 图 都 没有 了	没事 没事
哈哈哈 你 也 去 现场 了	嗯 嗯 去 嘉兴 了
嗯 嗯 去 嘉兴 了	哈哈哈 那天 看 直播 了
哈哈哈 那天 看 直播 了	嗯 直播 的 妹子 设备 很 专业
治 啥 失眠	专治 各种 外来 杂音
专治 各种 外来 杂音	收藏
干嘛 去 了	去 医院 了
去 医院 了	你 皮肤病 又 犯 了
你 皮肤病 又 犯 了	并 不是 反正 去 医院 就是 很 难受
并 不是 反正 去 医院 就是 很 难受	确实 味道 就 不好 闻
记得 他 的 十三岁 生日 是 我们 陪 他 一起 过 的 十四岁 就让 这些 他 的 新 伙伴 陪 他 过 吧 祝福 他 天天开心 快快乐乐 岁 生日快乐 醋哥 没 听 清楚 他们 叫 你 什么 名字 但是 我 就 还是 喜欢 叫 你 醋 哥 嗯 就 叫 醋 哥 了	瑞飞儿 .
瑞飞儿 .	哦 瑞飞儿 蛮 好 记 的 嘛
好听 哦	对 呀 不好 听 就 不 分享 了
对 呀 不好 听 就 不 分享 了	谢谢 分享 哦
该 更 博咯	最近 没什么 想发 的 嘛
最近 没什么 想发 的 嘛	那 你 是 发福 了 吧
不错呀	小 厨娘 的 称号 是 有 的 吧
小 厨娘 的 称号 是 有 的 吧	嗯 嗯 绝对 哒
不错 不错	雪雪 这么晚 还 不 睡 哦
雪雪 这么晚 还 不 睡 哦	我 那会儿 才 六点 多 啊 我们 有时 差 啦
我 那会儿 才 六点 多 啊 我们 有时 差 啦	可怕 居然 有时 差
图美 文字 更美爱 你 老婆	老公 请 翻译
老公 请 翻译	长长的 思念 就 像 风筝 断了线 飘 啊 飘 啊 飘 到 你 的 身边
图美 是因为 爱情 很 美	是 呢 呀
是 呢 呀	晚安
晚安	晚安
图 不错	免费 哦 可以 找 珂 爱 的 小羊 给 你 做 的
免费 哦 可以 找 珂 爱 的 小羊 给 你 做 的	好 耶
该 放手 时 就 放手 风风火火 煮 碗 粥	热恋 中 你 这 评论 真真是 想 挨打
热恋 中 你 这 评论 真真是 想 挨打	你 笑 了 就 好 我 才 不管 你 打 的 我 多 疼 呢
你 笑 了 就 好 我 才 不管 你 打 的 我 多 疼 呢	厉害 了 佩服 你 的 逗笑 功能 随时随地
太瘦 了	还要 更 窈窕
还要 更 窈窕	你们 那里 风不大 吧
你们 那里 风不大 吧	沙尘暴 你 来 感受 下
沙尘暴 你 来 感受 下	关键 是 别 刮 跑 了
关键 是 别 刮 跑 了	猜到 了 开头 没 猜 对 结局
你够 瘦 了	身高 是 硬伤 差不多 的 身高 腿 还是 不够 细
身高 是 硬伤 差不多 的 身高 腿 还是 不够 细	好 吧
为了 夏天	脚 好了吗
脚 好了吗	还 没 咧 在 长肉 超级 痒
不要 放弃	是 啊 是 啊 很多 事 都 是 坚持 了 才 有 结果
是 啊 是 啊 很多 事 都 是 坚持 了 才 有 结果	所以 你 坚持 知道 吗
瘦 啊 我 也 要 努力 了	我要 瘦 回
我要 瘦 回	加油 加油
加油 你 已经 很瘦 啦	那 是因为 你 不 知道 偶滴 身高
那 是因为 你 不 知道 偶滴 身高	身高 又 怎么 了
身高 又 怎么 了	说 的 好 呀
总是 给 我 秒 赞 我 记下 了	巧 了 正好 睡前 看眼 微博
巧 了 正好 睡前 看眼 微博	快睡吧 好 梦
祝福	哈哈 是 和 闺蜜 的 第七年 哦
哈哈 是 和 闺蜜 的 第七年 哦	祝福 哦 嘿嘿
人家 能 控球 能 传球 还 能 拼抢 再 瞅 瞅 咱们	脾气 不小 哈哈哈
脾气 不小 哈哈哈	跑 不过 你 我 就 推倒 你
跑 不过 你 我 就 推倒 你	我 开始 追 伊朗队 了
我 开始 追 伊朗队 了	西班牙 分 分钟 秒 伊朗 啊
西班牙 分 分钟 秒 伊朗 啊	西班牙 是 我 的 挚爱 不会 始乱终弃
西班牙 是 我 的 挚爱 不会 始乱终弃	毒奶 今天 曾诚 加油
一 杆子 弄死 一船 人	天秤座 简直 就是 毒蝎 心肠
天秤座 简直 就是 毒蝎 心肠	明明 是 超级 善良 可爱
明明 是 超级 善良 可爱	我 这 两天 被 虐待 的 呀
我 这 两天 被 虐待 的 呀	笑 着 活下去
哈哈哈 分好 了 江苏 四川 辽宁 八一 福建 云南	这样 分去 看球 真远 除了 四川
这样 分去 看球 真远 除了 四川	哈哈哈 今天 比赛结果 好像 河南 第名 了 八一 可以 和 河南 一组 了
哈哈哈 今天 比赛结果 好像 河南 第名 了 八一 可以 和 河南 一组 了	哈哈哈哈 哈哈哈 这是 好消息
我前 阵子 也 在 看 还 剩下 最后 两集	什么 戏
什么 戏	江阴 要塞 解放战争 时期 地下党 的 事栋 哥本音 青涩 但是 演技 不输帅帅 哒
聞聞	之前 站 看 了 敲 可 愛
之前 站 看 了 敲 可 愛	我 才 看到 真的 好 可爱
哇 任达华 穿 上 这个 立马 就 有 港片 的 气氛 出来 了 感觉 就是 飞虎队 队长 带领 着 自己 的 新手 小队 的 感觉 啊	隊長 難道 不是 陳 偉霆 嗎 畢竟 張 大佛 爺
隊長 難道 不是 陳 偉霆 嗎 畢竟 張 大佛 爺	太嫩 了 毕竟 任达华 一直 都 在 演 警察 队长 这 角色
情人节 快乐	不 快乐
不 快乐	那 也 要 好好 的
这个 可以 有	大表哥 今晚 订 的 哪家 酒店
大表哥 今晚 订 的 哪家 酒店	家里 蹲
春雨 李	你 鼓 什么 掌
你 鼓 什么 掌	腿短 呀
渣浪 我 要 发图	一辈子 记得 到 你 今天 说 我 跟 那个 垃圾桶 一样 高
一辈子 记得 到 你 今天 说 我 跟 那个 垃圾桶 一样 高	哈哈哈哈 余生 还要 请 你 指教
哈哈哈哈 余生 还要 请 你 指教	我 自己 瞎过
你 的 兄弟 好像 一眼 就 看到 了 重点	老子 躺 上床 发现 我 没 过来 找 你
老子 躺 上床 发现 我 没 过来 找 你	好 的
好 的	快点 睡 我 的哥
快点 睡 我 的哥	夜生活 才 刚刚开始
也许 做 什么 都 是 对 也许 做 什么 都 是 错 何必 强求	哈哈哈 哈哈 帅忠 我 只有 在 微博能 看到 你
哈哈哈 哈哈 帅忠 我 只有 在 微博能 看到 你	为什么 因为 你 时间 太紧 凤 宝宝 人缘 太好 经常 被 预约 哪里 有 时间 看见 我
为什么 因为 你 时间 太紧 凤 宝宝 人缘 太好 经常 被 预约 哪里 有 时间 看见 我	凤 宝宝 现在 闲死 了 可是 你 走 得 远远 的
凤 宝宝 现在 闲死 了 可是 你 走 得 远远 的	凤 宝宝 前两天 儿 跟 我 聊天 的 时间 都 没 宝宝 我 才 去 应聘 复试 不知 过 没 过心 很 累要 抱抱
凤 宝宝 前两天 儿 跟 我 聊天 的 时间 都 没 宝宝 我 才 去 应聘 复试 不知 过 没 过心 很 累要 抱抱	可以 的 可以 的 要 回来 找 我们 耍
可以 的 可以 的 要 回来 找 我们 耍	会 的 会 的 我 要 回来 拿证 但是 时间 不是 很 充足 要 不要 跟 宝宝 一起 吃个 酣畅淋漓 的 火锅 来 一次 不醉 不 罢休 的 接风酒
会 的 会 的 我 要 回来 拿证 但是 时间 不是 很 充足 要 不要 跟 宝宝 一起 吃个 酣畅淋漓 的 火锅 来 一次 不醉 不 罢休 的 接风酒	现在 就 想 我 烦死 这 两天 我 快死了
现在 就 想 我 烦死 这 两天 我 快死了	为 莫子 叻 恋爱 啦
为 莫子 叻 恋爱 啦	想 多
想 多	咋啦 咋啦 跟 宝宝 分享
咋啦 咋啦 跟 宝宝 分享	晚上 说
赶快 把 你家 女儿 发展 成小迷妹 一定 要 从 娃娃 抓起	哈哈 这个 可以 有 说不定 天天 给 她 看 帅哥 自己 也 会 变靓
哈哈 这个 可以 有 说不定 天天 给 她 看 帅哥 自己 也 会 变靓	当然 可以 有 了 抓紧 培养
若 不 经历 波折 怎能 让 人 成长 加油 吧 少年	哈哈 还 少年 呢 老 啦
哈哈 还 少年 呢 老 啦	心不老 就行
心不老 就行	确实 心不老 我 感觉 我 心理 挺 幼稚 的
这个 是 我 的 心头 爱	泡 开水 喝
泡 开水 喝	拿个 茶缸 放点 糖
求 经验 我 的 体重 怎么 没有 波动 呢	你 是 怎么 减 的
你 是 怎么 减 的	主食 尽量 换成 粗粮 七分 饱 上班时间 抽空 爬 爬楼梯 和 跳绳 晚上 慢跑 和 拉伸
主食 尽量 换成 粗粮 七分 饱 上班时间 抽空 爬 爬楼梯 和 跳绳 晚上 慢跑 和 拉伸	哦 那 你 那个 比较慢 而且 瘦 了 之后 也 要 保持 这个 运动 我 那 时候 减 的 到 现在 都 没 反弹
哦 那 你 那个 比较慢 而且 瘦 了 之后 也 要 保持 这个 运动 我 那 时候 减 的 到 现在 都 没 反弹	应该 怎么 减 呢
没有 就 只有 一次 还是 无意 中 的 去年 暑假 两个 多月 天天 躺 在家 玩 手机 吃 的 很少 结果 瘦到 了 多斤 后来 上学 了 吃 多 了 就 又 到 了 原来 体重 这 几年 的 体重 一直 都 保持 在 到 就 是从 这个 国庆节 之后 体重 就 突然 了 好 奇怪 可是 没 办法 脸圆 了 腿 也 粗 了 想 变 瘦 啊	我 之前 就是 高中 画画 然后 就 吃 的 也 多 下半身 偏胖 的 现在 瘦 了 好多
我 之前 就是 高中 画画 然后 就 吃 的 也 多 下半身 偏胖 的 现在 瘦 了 好多	那 你 怎么 瘦 的 啊
那 你 怎么 瘦 的 啊	我用 同学 买 的 咖啡 霜
你 怎么 瘦 的 这么 快 呀 有 什么 方法 吗 因为 我 最近 长胖 了 也 想 减肥 毕竟 快要 回家 过年 了	你 想 减 多少
你 想 减 多少	当然 如果 瘦到 就 最好 咯
当然 如果 瘦到 就 最好 咯	那 是 女人 都 是 能 瘦 则 瘦 你 之前 减过 没有 啊
那 是 女人 都 是 能 瘦 则 瘦 你 之前 减过 没有 啊	哦 哦 你 多 大 啊 现在 还 在 读书
哦 哦 你 多 大 啊 现在 还 在 读书	啊 在 上 大学
错 了 是 好 了 多久	几个 月 了 吧
几个 月 了 吧	不错 耶 继续 保持
不错 耶 继续 保持	你 也 要 治疗 哦 别 弄 严重 了
你 的 颈椎 也 有 钙化 点 么 会 不会 头晕 呢	会 还 想 吐 现在 好多 了
会 还 想 吐 现在 好多 了	你 是 如何 保养 的 呢 求 解答 好 了 好多 了 呢
不错 哦 失眠 是 个 大 问题	你 也 失眠
你 也 失眠	会 熬夜
会 熬夜	熬夜 和 失眠 是 两码事 好 么
熬夜 和 失眠 是 两码事 好 么	压力 大 以后 要 减压 了
哈哈哈哈	笑 什么
笑 什么	笑 你 漂亮 啊
笑 你 漂亮 啊	也 是 新疆 的
也 是 新疆 的	不是
这 都 不算 啥 爱来 的 时候 还 一起 泡澡 呢	其实 我 看过 这个 发布会 视频 饰演 多铎 的 张天阳 是 有意 想 炒 基情 的 但是 栋哥 好像 不乐意 一脸 心不在焉 敷衍 的 样子 紧跟着 于 正 急不可待 的 接口 说 这戏 不是 基情 戏 现场 很 微妙 也 可能 是 我 的 错觉
其实 我 看过 这个 发布会 视频 饰演 多铎 的 张天阳 是 有意 想 炒 基情 的 但是 栋哥 好像 不乐意 一脸 心不在焉 敷衍 的 样子 紧跟着 于 正 急不可待 的 接口 说 这戏 不是 基情 戏 现场 很 微妙 也 可能 是 我 的 错觉	那个 发布会 我 看过 是 粉丝 拍 的 太糊 我 喜欢 你 那个游戏 那里 觉得 韩栋栋 好 机智
那个 发布会 我 看过 是 粉丝 拍 的 太糊 我 喜欢 你 那个游戏 那里 觉得 韩栋栋 好 机智	我 觉得 还 可以 啊 起码 表情 什么 的 看 的 很 清楚 那个 什么游戏 还 没 看到
我 觉得 还 可以 啊 起码 表情 什么 的 看 的 很 清楚 那个 什么游戏 还 没 看到	咱俩 看 的 是 一个 吗 我 那个 感觉 是 粉丝 拍 的 因为 镜头 一直 都 追随 他 就是 主持人 让 介绍 剧里 的 人物 关系 韩栋栋 就 说 我们 做个 游戏吧 然后 特别 明白 的 就 呈现出 关系 了
咱俩 看 的 是 一个 吗 我 那个 感觉 是 粉丝 拍 的 因为 镜头 一直 都 追随 他 就是 主持人 让 介绍 剧里 的 人物 关系 韩栋栋 就 说 我们 做个 游戏吧 然后 特别 明白 的 就 呈现出 关系 了	肯定 不是 同一个 以为 视角 的 我 也 看到 过 不过 三秒钟 就点 叉叉 了
乐乐 弟弟 哥 从小到大 我 都 是 用 你 二手 的 乐乐 你 啥意思 弟弟 我 住 你 住 过 的 地方 我 穿 你 穿过 的 衣服 你 吃剩 的 东西 给 我 吃 你 用 过 的 东西 我用 全是 二手 的 乐乐 狠狠 说道 尼玛 你 敢 打 我 师父 的 主意 试试 我 跟 你 没完	我 弟弟 对小受 很 挑剔 的 你 没戏
我 弟弟 对小受 很 挑剔 的 你 没戏	不拉黑 你 你 都 要 上天 了
不拉黑 你 你 都 要 上天 了	什么 你 都 截图
